1,1,1,1,1,1,1,1,1,1,1,1,1,1,1,1,1,1,1,1,1,1,1,1,1,1,1,1,1,1,1,1
1,1,1,1,1,2,2,2,2,2,2,2,2,2,2,2,2,2,2,2,2,2,2,2,2,2,2,1,1,1,1,1
1,1,-1,2,2,2,0,0,2,0,0,0,0,0,0,0,0,0,0,0,0,0,0,0,0,0,2,2,2,-1,1,1
1,1,2,2,0,0,0,2,2,2,2,2,2,2,2,2,-1,2,2,2,2,2,2,2,2,0,0,0,2,2,1,1
1,1,2,0,0,2,2,2,0,0,0,2,0,0,0,0,0,0,0,0,0,0,0,0,2,2,2,0,0,2,1,1
1,2,2,0,2,2,0,0,0,2,2,2,2,2,2,2,2,2,2,2,3,2,2,0,0,0,2,2,0,2,2,1
1,2,0,0,2,0,0,2,2,2,0,0,0,0,2,0,0,0,0,0,0,0,2,2,2,0,0,2,0,0,2,1
1,2,0,2,2,0,2,2,0,0,0,2,2,2,2,2,2,2,2,2,2,0,0,0,2,2,0,2,2,2,2,1
1,2,0,2,0,0,2,0,0,2,2,2,0,0,0,0,0,2,0,0,2,2,2,0,0,2,0,0,2,0,2,1
1,2,0,2,0,2,2,0,2,2,0,0,0,2,2,2,2,2,2,0,0,0,2,2,0,2,2,2,2,0,2,1
1,2,0,2,0,2,0,0,2,0,0,3,2,2,0,0,0,0,2,2,2,0,0,2,0,0,2,0,2,0,2,1
1,2,0,2,0,2,2,2,2,0,2,2,0,0,0,2,-1,0,0,0,2,2,0,2,2,2,2,0,2,0,2,1
1,2,0,2,0,2,0,2,2,0,2,2,0,0,0,-1,2,0,0,0,2,2,0,2,2,0,2,0,2,0,2,1
1,2,0,2,2,2,0,0,2,0,0,2,2,2,0,0,0,0,2,2,2,0,0,2,0,0,2,0,2,0,2,1
1,2,0,2,0,2,2,0,2,2,0,0,0,2,2,2,2,2,2,0,0,0,2,2,0,2,2,0,2,0,2,1
1,2,2,2,0,0,2,0,0,2,2,2,0,0,0,0,2,0,0,0,3,2,2,0,0,2,0,0,2,0,2,1
1,2,0,2,2,0,2,2,0,0,0,2,2,2,2,2,2,2,2,2,2,0,0,0,2,2,0,2,2,0,2,1
1,2,0,0,2,0,0,2,2,2,0,0,0,2,0,0,0,0,0,0,0,0,2,2,2,0,0,2,0,0,2,1
1,2,2,0,2,2,0,0,0,2,2,2,2,2,2,2,2,2,2,2,2,-1,2,0,0,0,2,2,0,2,2,1
1,1,2,0,0,2,2,2,0,0,0,0,0,0,0,0,2,0,0,0,0,0,0,0,2,2,2,0,0,2,1,1
1,1,2,2,0,0,0,2,2,2,2,3,2,2,2,2,2,2,2,2,2,2,2,2,2,0,0,0,2,2,1,1
1,1,-1,2,2,2,0,0,0,0,0,0,0,0,0,0,0,0,0,2,0,0,0,0,0,0,2,2,2,-1,1,1
1,1,1,1,1,2,2,2,2,2,2,2,2,2,2,2,2,2,2,2,2,2,2,2,2,2,2,1,1,1,1,1
1,1,1,1,1,1,1,1,1,1,1,1,1,1,1,1,1,1,1,1,1,1,1,1,1,1,1,1,1,1,1,1
16,11
15,12
29,21
29,2
2,21
2,2
3,2,300
16,3,21,18
1002,960,920,450,400,300,225,175,150,100,50,0
2
15,11,2,16,10,0
16,12,2,15,13,0