1,1,1,1,1,1,1,1,1,1,1,1,1,1,1,1,1,1,1,1,1,1,1,1,1,1,1,1,1,1,1,1
1,-1,-1,2,2,2,2,2,2,2,1,1,2,2,2,2,2,2,2,2,2,2,1,1,2,2,2,2,2,2,2,1
1,-1,2,0,0,0,0,2,0,2,2,2,2,0,2,0,0,0,0,2,0,2,2,2,2,0,2,0,2,0,2,1
1,-1,2,2,2,2,2,3,0,2,0,0,0,0,2,0,2,2,2,2,0,2,0,0,0,0,2,0,2,0,2,1
1,2,2,0,2,0,0,0,0,2,0,2,2,2,2,0,2,0,0,0,0,2,0,2,2,2,2,0,2,0,2,1
1,2,0,0,2,0,2,2,2,3,2,2,0,0,0,0,2,0,2,2,2,2,0,2,0,0,0,0,2,0,2,1
1,2,2,2,2,0,2,0,0,0,0,2,0,2,2,2,2,0,2,0,0,0,0,2,0,2,2,2,2,0,2,1
1,2,0,0,0,0,2,0,2,2,2,3,2,2,0,0,0,0,2,0,2,2,2,2,0,2,0,0,0,0,2,1
1,2,0,2,2,2,2,0,2,0,0,0,0,2,0,2,2,2,2,0,2,0,0,0,0,2,0,2,2,2,2,1
1,2,0,2,0,0,0,0,2,0,2,2,2,3,2,2,0,0,0,0,2,0,-1,2,2,2,0,2,0,2,1,1
1,2,0,2,0,2,2,2,2,0,2,0,0,0,0,2,0,2,2,2,2,0,2,0,0,0,0,2,0,2,1,1
1,2,2,2,0,2,0,0,0,0,2,0,2,2,2,3,2,2,0,0,0,0,2,0,2,2,2,2,0,2,1,1
1,2,0,0,0,2,0,2,2,2,2,0,2,0,0,0,0,2,0,2,2,2,2,0,2,0,0,0,0,2,1,1
1,2,2,2,2,2,0,2,0,0,0,0,2,0,2,2,2,3,2,2,0,0,0,0,2,0,2,2,2,2,2,1
1,1,2,0,0,0,0,2,0,2,2,2,-1,0,2,0,0,0,0,2,0,2,2,2,2,0,2,0,0,0,2,1
1,1,2,0,2,2,2,2,0,2,0,0,0,0,2,0,2,2,2,3,2,2,0,0,0,0,2,0,2,2,2,1
1,2,2,0,2,0,0,0,0,2,0,2,2,2,2,0,2,0,0,0,0,2,0,2,2,2,2,0,2,0,2,1
1,2,0,0,2,0,2,2,2,2,0,2,0,0,0,0,2,0,2,2,2,3,2,2,0,0,0,0,2,0,2,1
1,2,2,2,2,0,2,0,0,0,0,2,0,2,2,2,2,0,2,0,0,0,0,2,0,2,2,2,2,0,2,1
1,2,0,0,0,0,2,0,2,2,2,2,0,2,0,0,0,0,2,0,2,2,2,3,2,2,0,0,0,0,2,1
1,2,0,2,2,2,2,0,2,0,0,0,0,2,0,2,2,2,2,0,2,0,0,0,0,2,0,2,2,-1,2,1
1,2,0,2,0,0,0,0,2,0,2,2,2,2,0,2,0,0,0,0,2,0,2,2,2,2,0,-1,0,0,2,1
1,2,2,2,2,2,2,2,2,2,2,1,1,2,2,2,2,2,2,2,2,2,2,1,1,2,2,2,2,2,2,1
1,1,1,1,1,1,1,1,1,1,1,1,1,1,1,1,1,1,1,1,1,1,1,1,1,1,1,1,1,1,1,1
29,20
27,21
1,1
2,1
1,2
1,3
3,2,300
12,14,22,9
1002,800,750,375,325,275,250,225,200,100,50,0
8
15,4,1,0,0,50
23,8,1,0,0,100
25,13,1,0,0,150
5,9,1,0,0,200
6,12,1,0,0,250
5,17,1,0,0,300
10,16,1,0,0,350
14,17,1,0,0,400