1,1,1,1,1,1,1,1,1,1,1,1,1,1,1,1,1,1,1,1,1,1,1,1,1,1,1,1,1,1,1,1
1,2,2,2,2,2,2,2,2,2,2,2,2,2,2,2,2,2,2,2,2,2,2,2,2,2,2,2,2,2,2,1
1,3,0,0,0,2,0,2,0,0,0,2,2,0,2,0,2,2,0,2,2,0,0,0,2,0,2,0,0,0,3,1
1,2,0,2,2,2,0,2,0,2,2,2,0,0,2,0,0,0,0,0,2,2,2,0,2,0,2,2,2,0,2,1
1,2,2,2,0,2,0,2,0,2,0,2,2,0,2,2,2,2,0,2,2,0,2,0,2,0,2,0,2,2,2,1
1,2,0,0,0,2,0,2,2,2,2,0,2,0,0,0,0,2,0,2,0,0,2,2,2,0,2,0,0,0,2,1
1,2,0,0,0,2,0,0,0,0,2,0,2,2,2,0,0,2,2,2,2,2,0,0,0,0,2,0,0,0,2,1
1,2,2,2,0,2,2,2,2,2,2,2,2,0,2,2,2,2,0,2,0,2,2,2,2,2,2,0,2,2,2,1
1,2,0,2,0,2,0,0,0,0,2,0,0,0,0,0,0,2,0,2,0,0,2,0,0,0,2,0,2,0,2,1
1,2,2,2,2,2,2,2,2,2,2,2,0,2,2,2,2,2,0,2,0,2,2,0,2,2,2,2,2,2,2,1
1,1,2,0,0,0,0,2,0,0,0,2,2,2,0,2,0,2,2,2,0,2,0,0,2,0,0,0,0,2,1,1
-1,2,2,0,0,2,2,2,0,0,0,0,0,0,0,2,0,0,0,0,0,2,2,0,2,2,2,0,0,2,2,-1
1,1,2,2,2,2,0,2,2,2,2,2,2,2,2,2,2,2,2,2,2,2,2,2,2,0,2,2,2,2,1,1
1,2,2,0,0,0,0,2,0,0,0,2,0,0,-1,-1,0,2,0,2,0,0,2,0,2,0,0,0,0,2,2,1
1,2,0,2,2,2,2,2,0,2,2,2,2,0,-1,-1,0,2,0,2,2,0,2,0,2,2,2,2,2,0,2,1
1,2,0,2,0,2,0,0,0,2,0,0,2,0,0,0,0,2,0,0,2,0,2,0,0,0,2,0,2,0,2,1
1,2,2,2,0,2,2,2,2,2,2,0,2,0,0,2,2,2,2,0,2,2,2,2,2,2,2,0,2,2,2,1
1,2,0,0,0,2,0,0,0,0,2,2,2,-1,-1,2,0,0,2,2,2,0,0,0,0,0,2,0,0,0,2,1
1,2,0,0,0,2,0,2,2,2,2,2,0,0,2,0,0,0,0,0,2,2,2,2,2,0,2,0,0,0,2,1
1,2,2,2,0,2,0,2,0,2,0,0,0,0,2,2,2,2,0,0,2,0,2,0,2,0,2,0,2,2,2,1
1,2,0,2,2,2,0,2,0,2,2,2,2,0,0,0,0,2,0,2,2,2,2,0,2,0,2,2,2,0,2,1
1,3,0,0,0,2,0,2,0,0,0,0,2,0,2,2,2,2,0,2,0,0,0,0,2,0,2,0,0,0,3,1
1,2,2,2,2,2,2,2,2,2,2,2,2,2,2,0,0,2,2,2,2,2,2,2,2,2,2,2,2,2,2,1
1,1,1,1,1,1,1,1,1,1,1,1,1,1,1,1,1,1,1,1,1,1,1,1,1,1,1,1,1,1,1,1
14,17
13,17
14,14
15,14
15,13
14,13
3,2,600
14,17,14,17
0,0,0,0,0,0,0,0,1000,0,0,0
0   