1,1,1,1,1,1,1,1,1,1,1,1,1,1,1,1,1,1,1,1,1,1,1,1,1,1,1,1,1,1,1,1
1,2,2,2,2,2,2,2,2,2,2,2,2,2,2,2,2,2,2,2,2,2,2,2,2,2,2,2,2,2,2,1
1,2,0,0,0,0,0,6,0,2,0,2,0,0,-1,0,2,0,2,0,0,0,6,0,2,0,6,0,0,0,2,1
1,2,0,6,6,6,0,6,0,2,0,2,0,2,2,0,2,0,2,6,6,0,6,0,2,0,6,0,0,0,2,1
1,2,6,6,0,6,6,6,0,2,0,2,0,2,0,0,2,0,2,0,6,0,6,0,2,0,6,6,6,0,2,1
1,2,0,0,0,0,0,0,0,2,0,2,2,2,2,2,2,0,2,0,6,0,6,0,2,0,0,0,6,0,2,1
1,2,2,2,2,3,2,2,2,2,0,2,0,2,0,0,2,0,2,0,6,6,6,0,2,0,0,0,6,6,2,1
1,2,0,0,0,0,0,0,0,2,2,2,0,2,2,0,2,0,2,0,0,0,0,0,2,0,0,0,0,0,2,1
1,2,0,0,6,6,6,6,0,2,0,2,0,0,2,0,2,0,2,2,2,2,2,2,2,2,2,3,2,2,2,1
1,2,6,6,6,0,0,6,6,2,0,2,2,2,2,2,2,2,2,0,0,0,0,0,2,0,0,0,0,0,2,1
1,2,0,0,0,0,0,0,0,2,0,2,1,1,1,1,2,0,2,6,6,6,6,0,2,0,0,0,0,0,2,1
1,2,2,2,2,2,2,2,2,2,0,2,1,-1,-1,-1,2,0,2,0,0,0,6,0,2,0,6,6,6,0,2,1
1,2,2,2,2,2,2,2,2,2,0,2,1,-1,-1,-1,2,0,2,0,6,6,6,0,2,0,6,0,6,6,2,1
1,2,0,0,0,0,0,0,0,2,0,2,1,1,1,1,2,0,2,0,6,0,0,0,2,6,6,0,0,0,2,1
1,2,0,0,0,0,0,6,6,2,0,2,2,2,2,2,2,2,2,0,6,0,0,0,2,0,0,0,0,0,2,1
1,2,0,0,6,6,6,6,0,2,0,2,0,2,0,0,2,0,2,2,2,2,2,2,2,2,2,3,2,2,2,1
1,2,0,0,6,0,0,0,0,2,2,2,0,2,2,0,2,0,2,0,0,0,0,0,2,0,6,0,0,0,2,1
1,2,2,2,2,3,2,2,2,2,0,2,0,0,2,0,2,0,2,0,6,6,6,6,2,0,6,0,0,0,2,1
1,2,0,6,0,0,0,0,0,2,0,2,2,2,2,2,2,0,2,0,6,0,0,0,2,0,6,6,6,0,2,1
1,2,0,6,0,6,6,6,0,2,0,2,0,0,2,0,2,0,2,0,6,6,6,0,2,0,0,0,6,0,2,1
1,2,0,6,6,6,0,6,0,2,0,2,0,2,2,0,2,0,2,0,0,0,6,0,2,0,6,6,6,0,2,1
1,2,0,0,0,0,0,6,0,2,0,2,0,-1,0,0,2,0,2,0,0,0,6,0,2,0,6,0,0,0,2,1
1,2,2,2,2,2,2,2,2,2,2,2,2,2,2,2,2,2,2,2,2,2,2,2,2,2,2,2,2,2,2,1
1,1,1,1,1,1,1,1,1,1,1,1,1,1,1,1,1,1,1,1,1,1,1,1,1,1,1,1,1,1,1,1
15,12
15,11
14,12
13,12
14,11
13,11
3,2,340
14,2,13,21
1002,900,850,420,360,240,150,90,60,20,0,0
0