1,1,1,1,1,1,1,1,1,1,1,1,1,1,1,1,1,1,1,1,1,1,1,1,1,1,1,1,1,1,1,1
1,2,2,2,2,2,2,2,2,2,2,2,2,2,2,2,2,2,2,2,2,2,2,2,2,2,2,2,2,2,2,1
1,2,0,2,0,0,0,0,2,0,0,0,2,0,0,0,0,0,0,2,0,0,0,2,0,0,0,0,2,0,2,1
1,2,0,3,2,2,2,2,2,2,2,2,2,2,2,2,2,2,2,2,2,2,2,2,2,2,2,2,3,0,2,1
1,2,0,2,0,0,2,0,0,0,0,2,0,0,0,0,2,0,0,0,2,0,0,0,0,2,0,0,2,0,2,1
1,2,0,2,0,2,2,2,2,2,2,2,2,2,2,2,2,2,2,2,2,2,2,2,2,2,2,0,2,0,2,1
1,2,0,2,2,2,0,0,0,2,0,0,0,0,2,0,0,0,2,0,0,0,2,0,0,0,2,2,2,0,2,1
1,2,2,2,0,2,2,2,2,2,2,2,2,2,2,2,2,2,2,2,2,2,2,2,2,2,2,0,2,2,2,1
1,2,0,2,0,0,2,0,0,0,0,2,0,0,-1,0,-1,0,0,0,2,0,0,0,0,2,0,0,2,0,2,1
1,2,0,2,2,2,2,2,2,2,2,2,2,2,2,2,2,2,2,2,2,2,2,2,2,2,2,2,2,0,2,1
1,2,0,2,0,0,0,0,2,0,0,0,2,0,0,0,0,0,0,2,0,0,0,2,0,0,0,0,2,0,2,1
1,2,2,2,2,2,2,2,2,2,2,2,2,2,2,-1,-1,2,2,2,2,2,2,2,2,2,2,2,2,2,2,1
1,2,0,0,0,0,0,0,0,0,2,0,0,0,0,-1,-1,0,0,0,0,2,0,0,0,0,0,0,0,0,2,1
1,2,2,2,2,2,2,2,2,2,2,2,2,2,2,2,2,2,2,2,2,2,2,2,2,2,2,2,2,2,2,1
1,2,0,0,0,2,0,2,0,2,0,0,2,0,0,0,2,0,0,2,0,0,2,0,2,0,2,0,0,0,2,1
1,2,0,2,2,2,0,2,2,2,0,0,2,2,2,2,2,0,0,2,0,0,2,2,2,0,2,2,2,0,2,1
1,2,2,2,0,2,0,2,0,2,0,0,2,0,0,0,2,0,0,2,0,0,2,0,2,0,2,0,2,2,2,1
1,2,0,0,0,2,2,2,0,2,0,0,2,0,0,0,2,0,0,2,0,0,2,0,2,2,2,0,0,0,2,1
1,2,0,3,2,2,0,2,0,2,2,0,2,2,2,2,2,2,2,2,0,2,2,0,2,0,2,2,3,0,2,1
1,2,2,2,0,2,0,2,0,0,2,0,2,0,2,0,0,2,0,2,0,2,0,0,2,0,2,0,2,2,2,1
1,2,0,0,0,2,0,2,2,2,2,0,2,0,2,0,0,2,0,2,0,2,2,2,2,0,2,0,0,0,2,1
1,2,0,2,2,2,0,2,0,0,2,0,2,0,2,0,0,2,0,2,0,2,0,0,2,0,2,2,2,0,2,1
1,2,2,2,0,2,2,2,2,2,2,2,2,2,2,2,2,2,2,2,2,2,2,2,2,2,2,2,2,2,2,1
1,1,1,1,1,1,1,1,1,1,1,1,1,1,1,1,1,1,1,1,1,1,1,1,1,1,1,1,1,1,1,1
16,8
14,8
16,11
16,12
15,12
15,11
3,2,400
16,8,16,8
1002,900,800,400,350,275,225,200,175,125,0,25
0