1,1,1,1,1,1,1,1,1,1,1,1,1,1,1,1,1,1,1,1,1,1,1,1,1,1,1,1,1,1,1,1
1,-1,2,2,2,2,2,2,2,2,2,2,2,2,2,2,2,2,2,2,2,2,2,2,2,2,2,2,2,2,-1,1
1,2,1,2,2,1,1,1,1,1,1,1,1,1,1,1,1,1,1,1,1,1,1,1,1,1,1,2,2,1,2,1
1,2,2,2,1,2,2,2,2,2,2,2,2,2,2,2,2,2,2,2,2,2,2,2,2,2,2,1,2,2,2,1
1,2,2,1,2,2,6,6,6,6,6,2,6,6,6,6,6,6,6,2,6,6,6,6,6,2,2,2,1,2,2,1
1,2,2,1,2,0,0,0,0,0,0,3,0,0,0,0,0,0,0,-1,0,0,0,0,0,0,2,2,1,2,2,1
1,2,2,1,2,6,6,6,6,6,6,2,6,6,6,6,6,6,6,2,6,6,6,6,6,6,2,2,1,2,2,1
1,2,2,1,2,2,2,2,2,2,2,2,2,2,2,2,2,2,2,2,2,2,2,2,2,2,2,2,1,2,2,1
1,2,2,1,2,2,2,2,1,1,2,2,1,1,1,1,1,1,1,1,2,2,1,1,2,2,2,2,1,2,2,1
1,2,2,1,2,2,2,1,-1,-1,1,2,2,2,2,2,2,2,2,2,2,1,-1,-1,1,2,2,2,1,2,2,1
1,2,2,1,2,2,2,1,-1,-1,1,2,2,2,2,2,2,2,2,2,2,1,-1,-1,1,2,2,2,1,2,2,1
1,2,2,1,2,2,2,2,1,1,2,2,1,1,1,1,1,1,1,1,2,2,1,1,2,2,2,2,1,2,2,1
1,2,2,1,2,2,2,2,2,2,2,2,2,2,2,2,2,2,2,2,2,2,2,2,2,2,2,2,1,2,2,1
1,2,2,1,2,0,0,0,0,0,0,2,0,0,0,0,0,0,0,0,2,0,0,0,0,0,0,2,1,2,2,1
1,2,2,1,2,6,6,6,6,6,6,-1,6,6,6,6,6,6,6,6,3,6,6,6,6,6,6,2,1,2,2,1
1,2,2,1,2,0,0,0,0,0,0,2,0,0,0,0,0,0,0,0,2,0,0,0,0,0,0,2,1,2,2,1
1,2,2,1,2,2,2,2,2,2,2,2,2,2,2,2,2,2,2,2,2,2,2,2,2,2,2,2,1,2,2,1
1,2,2,1,1,1,1,1,1,1,1,1,1,1,1,1,1,1,1,1,1,1,1,1,1,1,1,1,1,2,2,1
1,2,2,1,2,2,2,2,2,2,2,2,2,2,2,2,2,2,2,2,2,2,2,2,2,2,2,2,1,2,2,1
1,2,1,3,-1,1,1,2,2,1,1,-1,2,1,1,1,1,1,1,2,-1,1,1,2,2,1,1,2,3,1,2,1
1,2,1,2,2,2,2,2,2,2,2,2,2,2,2,2,2,2,2,2,2,2,2,2,2,2,2,2,2,1,2,1
1,2,1,1,1,1,1,1,1,1,1,1,1,1,1,1,1,1,1,1,1,1,1,1,1,1,1,1,1,1,2,1
1,2,2,2,2,2,2,2,2,2,2,2,2,2,2,-1,2,2,2,2,2,2,2,2,2,2,2,2,2,2,2,1
1,1,1,1,1,1,1,1,1,1,1,1,1,1,1,1,1,1,1,1,1,1,1,1,1,1,1,1,1,1,1,1
1,1
30,1
11,14
19,5
4,19
15,22
3,2,400
11,19,20,19
1002,950,900,350,300,225,175,150,125,100,50,25
3
30,20,2,29,20,0
12,19,2,12,17,0
19,19,2,19,17,0