1,1,1,1,1,1,1,1,1,1,1,1,1,1,1,1,1,1,1,1,1,1,1,1,1,1,1,1,1,1,1,1
1,2,2,2,2,2,2,2,2,2,2,2,0,0,3,2,2,2,2,2,2,2,2,2,2,2,2,2,0,2,2,1
1,2,0,0,0,2,0,0,0,0,0,2,2,0,2,0,0,0,0,0,0,0,2,2,2,2,2,2,0,2,2,1
1,2,0,3,2,2,0,0,-1,2,2,2,2,0,2,0,2,2,2,2,-1,0,2,0,0,0,0,0,0,0,2,1
1,2,0,2,2,2,2,2,2,0,0,0,0,0,2,2,2,0,0,0,2,0,2,0,0,2,2,2,2,0,2,1
1,2,0,2,2,0,0,0,0,0,2,-1,2,0,0,0,0,2,2,2,2,2,2,0,0,2,1,1,2,0,2,1
1,2,0,0,0,0,2,2,2,2,2,1,2,2,2,2,0,2,2,0,0,0,0,0,0,2,1,1,2,0,2,1
1,2,0,0,2,2,2,1,2,1,2,1,2,1,1,2,0,0,0,0,2,2,2,2,2,2,2,2,2,2,2,1
1,2,2,0,2,1,2,1,2,1,2,1,2,2,2,2,2,2,2,2,2,2,0,0,0,0,0,0,0,0,0,1
1,2,2,0,2,1,2,1,2,1,2,1,2,1,1,1,1,1,2,2,2,0,0,2,2,2,2,2,2,2,2,1
1,0,0,0,2,1,2,1,2,1,2,1,2,1,-1,2,2,1,2,2,0,0,2,2,2,2,0,0,0,0,2,1
1,2,2,0,2,2,2,1,-1,2,2,1,2,1,2,1,2,1,2,0,2,2,2,0,0,0,0,-1,3,0,2,1
1,2,2,0,0,2,2,1,1,1,1,1,2,1,2,1,2,1,2,0,2,2,2,2,2,2,0,2,2,0,2,1
1,2,2,2,2,0,2,2,2,2,2,2,2,1,2,2,2,2,2,0,0,2,2,0,0,2,2,2,2,2,2,1
1,2,0,0,2,0,0,2,2,1,1,1,2,2,2,1,2,1,2,2,0,0,2,2,2,0,0,0,0,0,2,1
1,2,0,0,2,2,0,0,2,2,2,1,1,1,1,1,2,1,1,2,2,0,0,0,2,2,0,0,0,0,2,1
1,2,0,0,2,2,0,0,0,0,-1,2,2,2,2,2,2,1,1,1,2,2,0,0,2,2,2,2,2,2,2,1
1,2,0,2,2,0,0,0,2,2,0,0,0,0,0,2,2,2,2,2,2,2,2,0,0,0,0,0,0,0,0,1
1,2,0,2,0,0,2,2,2,2,2,2,2,2,0,0,2,2,0,0,0,2,2,0,0,0,0,2,2,2,2,1
1,2,0,2,0,0,2,0,0,2,0,0,0,2,2,0,0,0,2,2,0,0,0,2,2,2,2,2,0,0,2,1
1,2,0,2,2,0,2,0,-1,2,0,0,0,2,2,2,2,2,2,2,2,0,0,2,0,0,3,2,2,0,2,1
1,2,0,0,2,0,2,0,2,0,0,2,3,0,0,2,0,0,0,0,2,2,0,2,0,0,0,0,2,0,2,1
1,3,2,2,2,0,2,2,2,2,2,2,2,2,2,2,2,2,2,2,2,2,0,2,2,2,2,2,2,2,2,1
1,1,1,1,1,1,1,1,1,1,1,1,1,1,1,1,1,1,1,1,1,1,1,1,1,1,1,1,1,1,1,1
8,11
14,10
8,20
8,3
27,11
20,3
3,2,360
11,5,10,16
1002,910,820,400,325,250,200,175,175,125,100,30
6
28,1,1,0,0,0
3,8,1,0,0,0
19,12,1,0,0,0
5,13,1,0,0,0
16,19,1,0,0,0
22,19,1,0,0,0