1,1,1,1,1,1,1,1,1,1,1,1,1,1,1,1,1,1,1,1,1,1,1,1,1,1,1,1,1,1,1,1
1,2,2,2,2,2,1,1,1,1,1,2,2,2,2,2,2,2,2,2,2,1,1,1,1,1,2,2,2,2,2,1
1,2,0,0,0,2,2,3,2,2,2,2,0,0,0,0,0,0,0,0,2,2,2,3,2,2,2,0,0,0,2,1
1,2,2,2,0,0,0,0,2,0,0,0,0,2,2,2,-1,2,2,0,0,0,0,2,0,0,0,0,2,2,2,1
1,2,0,2,2,2,2,0,2,0,2,2,2,2,0,2,2,0,2,2,2,2,0,2,0,2,2,2,2,0,2,1
1,2,2,0,0,0,2,0,2,0,2,0,0,0,2,2,2,2,0,0,0,2,0,2,0,2,0,0,0,2,2,1
1,2,-1,0,0,0,2,0,2,0,2,0,0,0,2,2,2,2,0,0,0,2,0,2,0,2,0,0,0,-1,2,1
1,2,0,2,2,2,2,0,2,0,2,2,2,2,0,2,2,0,2,2,2,2,0,2,0,2,2,2,2,0,2,1
1,2,2,2,0,0,0,0,2,0,0,0,0,2,2,-1,2,2,2,0,0,0,0,2,0,0,0,0,2,2,2,1
1,2,0,0,0,2,2,2,2,2,2,2,0,0,0,0,0,0,0,0,2,2,2,2,2,2,2,0,0,0,2,1
1,2,2,2,2,2,0,0,2,0,0,2,2,2,2,2,2,2,2,2,2,0,0,2,0,0,2,2,2,2,2,1
1,2,0,0,0,2,0,2,2,-1,0,2,0,0,0,0,0,0,0,0,2,0,-1,2,2,0,2,0,0,0,2,1
1,2,0,0,0,2,0,2,2,2,0,2,0,0,0,0,0,0,0,0,2,0,2,2,2,0,2,0,0,0,2,1
1,2,2,2,2,2,0,0,2,0,0,2,2,2,2,2,2,2,2,2,2,0,0,2,0,0,2,2,2,2,2,1
1,2,0,0,0,2,2,2,2,2,2,2,0,0,0,0,0,0,0,0,2,2,2,2,2,2,2,0,0,0,2,1
1,2,2,2,0,0,0,0,2,0,0,0,0,2,2,2,2,2,2,0,0,0,0,2,0,0,0,0,2,2,2,1
1,2,0,2,2,2,2,0,2,0,2,2,2,2,0,2,2,0,2,2,2,2,0,2,0,2,2,2,2,0,2,1
1,2,2,0,0,0,2,0,2,0,2,0,0,0,2,2,2,2,0,0,0,2,0,2,0,2,0,0,0,2,2,1
1,2,-1,0,0,0,2,0,2,0,2,0,0,0,2,2,2,2,0,0,0,2,0,2,0,2,0,0,0,-1,2,1
1,2,0,2,2,2,2,0,2,0,2,2,2,2,0,2,2,0,2,2,2,2,0,2,0,2,2,2,2,0,2,1
1,2,2,2,0,0,0,0,2,0,0,0,0,2,2,2,2,2,2,0,0,0,0,2,0,0,0,0,2,2,2,1
1,2,0,0,0,2,2,2,3,2,2,2,0,0,0,0,0,0,0,0,2,2,2,3,2,2,2,0,0,0,2,1
1,2,2,2,2,2,1,1,1,1,1,2,2,2,2,2,2,2,2,2,2,1,1,1,1,1,2,2,2,2,2,1
1,1,1,1,1,1,1,1,1,1,1,1,1,1,1,1,1,1,1,1,1,1,1,1,1,1,1,1,1,1,1,1
16,3
15,8
2,6
2,18
29,6
29,18
3,2,400
9,11,22,11
1002,950,900,380,290,215,165,140,115,70,60,30
3
14,6,2,15,2,0
6,6,2,16,21,0
16,20,2,16,21,0