1,1,1,1,1,1,1,1,1,1,1,1,1,1,1,1,1,1,1,1,1,1,1,1,1,1,1,1,1,1,1,1
2,2,2,2,2,2,2,2,1,2,2,2,2,2,2,2,2,2,2,2,2,2,2,1,2,2,2,2,2,2,2,1
1,2,0,2,0,2,0,2,1,2,1,1,1,1,1,2,1,1,1,1,1,1,2,1,2,0,2,0,2,0,2,1
1,2,0,2,0,2,0,2,1,2,1,3,2,2,0,2,2,0,2,2,3,1,2,1,2,0,2,0,2,0,2,1
1,2,0,2,0,2,0,2,1,2,1,2,0,2,0,0,2,0,2,0,2,1,2,1,2,0,2,0,2,0,2,1
1,2,0,2,0,2,0,2,1,2,1,2,0,2,0,0,2,0,2,0,2,1,2,1,2,0,2,0,2,0,2,1
1,2,0,2,0,2,0,2,1,2,1,2,0,2,0,2,2,0,2,0,2,1,2,1,2,0,2,0,2,0,2,1
1,2,0,2,0,2,0,2,1,2,1,2,0,2,0,2,0,0,2,0,2,1,2,1,2,0,2,0,2,0,2,1
1,2,0,2,0,2,0,2,1,2,1,2,0,2,0,2,2,0,2,0,2,1,2,1,2,0,2,0,2,0,2,1
1,2,0,2,0,2,0,2,1,2,1,2,0,2,0,0,2,0,2,0,2,1,2,1,2,0,2,0,2,0,2,1
1,2,0,2,0,2,0,2,1,2,1,2,0,2,0,2,2,0,2,0,2,1,2,1,2,0,2,0,2,0,2,1
1,2,0,2,-1,2,0,2,-1,2,1,2,0,2,0,2,0,0,2,0,2,1,2,-1,2,0,2,-1,2,0,2,1
1,2,0,2,2,2,0,2,-1,2,1,2,0,2,2,-1,-1,0,2,0,2,1,2,-1,2,0,2,2,2,0,2,1
1,2,0,2,0,2,0,2,1,2,1,2,0,2,0,0,2,0,2,0,2,1,2,1,2,0,2,0,2,0,2,1
1,2,0,2,0,2,0,2,1,2,1,2,0,2,0,2,2,0,2,0,2,1,2,1,2,0,2,0,2,0,2,1
1,2,0,2,0,2,0,2,1,2,1,2,0,2,0,2,0,0,2,0,2,1,2,1,2,0,2,0,2,0,2,1
1,2,0,2,0,2,0,2,1,2,1,2,0,2,0,2,2,0,2,0,2,1,2,1,2,0,2,0,2,0,2,1
1,2,0,2,0,2,0,2,1,2,1,2,0,2,0,0,2,0,2,0,2,1,2,1,2,0,2,0,2,0,2,1
1,2,0,2,0,2,0,2,1,2,1,2,0,2,0,2,2,0,2,0,2,1,2,1,2,0,2,0,2,0,2,1
1,2,0,2,0,2,0,2,1,2,1,2,0,2,0,2,0,0,2,0,2,1,2,1,2,0,2,0,2,0,2,1
1,2,0,2,0,2,0,2,1,2,1,2,2,2,0,2,2,2,2,2,2,1,2,1,2,0,2,0,2,0,2,1
1,2,0,2,0,2,0,2,1,2,1,1,1,1,1,1,1,1,1,1,1,1,2,1,2,0,2,0,2,0,2,1
1,2,2,2,2,2,2,2,1,2,2,2,2,2,2,2,2,2,2,2,2,2,2,1,2,2,2,2,2,2,2,2
1,1,1,1,1,1,1,1,1,1,1,1,1,1,1,1,1,1,1,1,1,1,1,1,1,1,1,1,1,1,1,1
27,11
4,11
23,12
23,11
8,12
8,11
3,2,600
15,12,16,12
1002,925,850,750,200,150,0,0,150,140,130,0
0