1,1,1,1,1,1,1,1,1,1,1,1,1,1,1,1,1,1,1,1,1,1,1,1,1,1,1,1,1,1,1,1
1,2,2,2,2,1,2,2,2,2,2,2,2,2,2,2,2,2,2,2,2,2,2,2,2,2,1,2,2,2,2,1
1,2,0,0,2,2,2,1,1,1,1,1,1,1,1,1,1,1,1,1,1,1,1,1,1,2,2,2,0,0,2,1
1,2,0,2,2,1,1,2,2,1,2,2,2,2,2,1,2,2,2,2,2,2,1,2,2,1,1,2,3,0,2,1
1,2,2,2,1,2,2,2,2,1,2,3,1,2,2,2,2,2,2,1,3,2,1,2,2,2,2,1,2,2,2,1
1,1,2,1,2,2,0,0,2,2,2,1,1,1,2,1,2,2,1,1,1,2,2,2,0,0,2,2,1,2,1,1
1,2,2,1,2,0,0,0,2,1,2,2,1,2,2,1,2,2,2,1,2,2,1,2,0,0,0,2,1,2,2,1
1,2,1,2,2,2,0,0,2,1,2,2,2,2,2,1,2,2,2,2,2,2,1,2,0,0,2,2,2,1,2,1
1,2,1,2,0,2,2,2,2,1,2,0,0,0,2,1,2,0,0,0,0,2,1,2,2,2,2,0,2,1,2,1
1,2,1,2,0,2,1,1,1,1,2,2,2,2,2,2,2,2,2,2,2,2,1,1,1,1,2,0,2,1,2,1
1,2,1,2,0,2,1,2,2,2,2,0,0,2,-1,1,2,2,0,0,0,2,2,2,2,2,2,0,2,1,2,1
1,2,1,2,0,2,1,-1,-1,1,2,0,2,2,1,1,1,2,2,2,0,-1,1,2,2,1,2,2,2,1,2,1
1,2,1,2,2,2,1,-1,-1,1,2,0,2,2,1,1,1,2,0,2,0,-1,1,2,2,1,2,0,2,1,2,1
1,2,1,2,0,2,2,2,2,2,2,0,0,2,2,1,-1,2,0,2,0,2,2,2,2,1,2,0,2,1,2,1
1,2,1,2,0,2,1,1,1,1,2,2,2,2,2,2,2,2,2,2,2,2,1,1,1,1,2,0,2,1,2,1
1,2,1,2,0,2,2,2,2,1,2,0,0,0,2,1,2,0,0,0,0,2,1,2,2,2,2,0,2,1,2,1
1,2,1,2,2,2,0,0,2,1,2,2,2,2,2,1,2,2,2,2,2,2,1,2,0,0,2,2,2,1,2,1
1,2,2,1,2,0,0,0,2,1,2,2,1,2,2,1,2,2,2,1,2,2,1,2,0,0,0,2,1,2,2,1
1,1,2,1,2,2,0,0,2,2,2,1,1,1,2,1,2,2,1,1,1,2,2,2,0,0,2,2,1,2,1,1
1,2,2,2,1,2,2,2,2,1,2,3,1,2,2,2,2,2,2,1,3,2,1,2,2,2,2,1,2,2,2,1
1,2,0,3,2,1,1,2,2,1,2,2,2,2,2,1,2,2,2,2,2,2,1,2,2,1,1,2,2,0,2,1
1,2,0,0,2,2,2,1,1,1,1,1,1,1,1,1,1,1,1,1,1,1,1,1,1,2,2,2,0,0,2,1
1,2,2,2,2,1,2,2,2,2,2,2,2,2,2,2,2,2,2,2,2,2,2,2,2,2,1,2,2,2,2,1
1,1,1,1,1,1,1,1,1,1,1,1,1,1,1,1,1,1,1,1,1,1,1,1,1,1,1,1,1,1,1,1
21,11
21,12
8,11
8,12
7,11
7,12
3,2,600
14,10,16,13
1002,925,850,330,275,200,150,125,100,70,30,15
2
8,8,2,7,2,0
23,15,2,24,21,0