1,1,1,1,1,1,1,1,1,1,1,1,1,1,1,1,1,1,1,1,1,1,1,1,1,1,1,1,1,1,1,1
1,-1,2,2,2,2,2,2,0,2,2,2,2,2,2,1,2,2,0,2,2,2,0,0,0,2,2,2,2,2,-1,1
1,2,2,0,0,2,0,2,2,2,0,0,0,0,2,1,2,2,2,2,0,2,2,2,2,2,0,0,2,0,2,1
1,2,2,0,2,2,0,0,3,2,0,2,2,2,2,1,0,2,0,0,0,0,0,0,0,2,0,0,2,2,2,1
1,2,0,0,2,2,2,0,0,0,0,2,0,0,2,1,2,2,0,0,2,2,3,0,0,2,2,0,0,2,2,1
-1,2,2,0,0,2,2,0,2,2,2,2,2,0,2,1,2,0,0,2,2,0,2,2,0,0,2,2,0,2,2,-1
1,0,2,2,2,2,0,0,2,2,0,0,2,2,2,1,2,2,2,2,2,0,2,2,2,0,0,2,2,2,2,1
1,2,2,0,2,0,0,2,2,2,2,0,0,0,2,1,2,0,0,0,0,0,0,0,2,0,0,0,0,0,2,1
1,2,2,0,2,2,2,2,0,0,2,2,2,2,2,1,2,2,2,2,2,2,2,2,2,2,2,2,2,2,2,1
1,1,1,1,1,1,1,2,1,1,1,1,1,1,1,1,1,1,1,1,1,1,1,1,2,1,1,1,1,1,1,1
1,2,2,2,2,2,2,2,2,2,2,2,2,2,2,1,2,2,2,2,2,2,2,2,2,2,2,2,2,2,2,1
1,-1,6,6,6,6,6,6,6,6,6,6,6,6,-1,1,-1,6,6,6,6,6,6,6,6,6,6,6,6,6,-1,1
1,2,2,2,2,2,2,2,2,2,2,2,2,2,2,1,2,2,2,2,2,2,2,2,2,2,2,2,2,2,2,1
1,1,1,1,1,1,1,2,1,1,1,1,1,1,1,1,1,1,1,1,1,1,1,1,2,1,1,1,1,1,1,1
1,2,2,2,0,2,2,2,0,2,2,2,2,2,2,1,2,2,2,0,0,2,2,2,2,2,2,2,2,2,2,1
1,2,0,2,0,2,0,2,2,2,2,0,0,0,2,1,2,0,2,2,2,2,0,0,0,0,0,0,0,2,2,1
1,2,0,2,2,2,0,0,2,0,2,2,2,0,2,1,2,0,2,0,0,2,2,0,3,2,2,2,0,2,2,1
-1,2,0,2,2,0,0,2,2,2,0,0,2,0,2,1,2,0,2,0,0,0,2,2,2,0,0,2,0,0,2,-1
1,2,0,0,0,0,0,2,0,3,2,0,2,0,2,1,2,2,2,2,2,0,0,2,2,0,0,2,0,2,2,1
1,2,2,2,0,2,2,2,0,0,2,0,2,0,2,1,2,0,2,0,2,0,0,0,2,2,0,2,0,2,0,1
1,2,0,2,2,2,0,2,2,2,2,0,2,0,2,1,2,0,2,2,2,2,2,0,0,2,2,2,0,2,2,1
1,2,0,0,0,0,0,0,2,0,0,0,2,0,2,1,2,0,0,0,0,0,2,0,0,2,0,0,0,0,2,1
1,-1,2,2,2,2,2,2,2,2,2,2,2,2,2,1,2,2,2,2,2,2,2,2,2,2,2,2,2,2,-1,1
1,1,1,1,1,1,1,1,1,1,1,1,1,1,1,1,1,1,1,1,1,1,1,1,1,1,1,1,1,1,1,1
14,11
16,11
30,1
30,22
1,1
1,22
3,2,600
1,11,30,11
1002,900,800,300,275,225,175,150,125,75,50,25
0