1,1,1,1,1,1,1,1,1,1,1,1,1,1,1,1,1,1,1,1,1,1,1,1,1,1,1,1,1,1,1,1
1,0,2,2,2,0,2,2,2,3,0,0,0,0,0,2,2,2,2,2,2,2,2,2,2,2,2,2,2,2,0,1
1,0,2,0,2,0,2,0,0,2,0,0,0,0,0,2,0,0,0,0,2,0,0,0,2,0,0,0,0,2,0,1
1,0,2,0,2,2,2,2,2,2,2,2,2,2,2,2,2,2,2,2,2,2,0,0,2,0,0,0,0,2,0,1
1,-1,2,0,2,0,0,0,0,2,0,0,0,0,0,0,0,2,0,0,0,2,0,0,2,2,2,2,2,2,-1,1
1,-1,0,0,2,2,2,2,0,2,0,0,0,0,0,0,0,2,2,2,0,2,0,0,2,0,0,0,0,0,2,1
1,-1,0,0,2,0,0,-1,0,2,2,2,2,2,2,2,0,0,0,2,0,2,0,0,2,0,0,0,0,2,-1,1
1,-1,2,0,2,0,0,2,2,2,0,0,0,0,0,2,0,0,2,2,0,2,0,0,2,2,2,2,0,2,0,1
1,0,2,0,2,0,0,0,0,2,0,0,2,2,2,2,0,0,2,0,0,2,0,0,0,0,0,2,0,2,0,1
1,0,2,2,2,2,2,2,2,2,0,0,2,0,0,2,2,2,2,0,0,2,0,2,2,2,0,2,2,2,0,1
1,0,2,0,0,2,0,0,0,0,0,0,2,2,0,2,0,0,0,0,0,2,2,2,0,2,0,2,0,0,0,1
1,0,2,0,0,2,2,2,2,0,0,0,0,2,0,2,0,0,0,0,0,2,0,0,0,2,0,2,2,2,0,1
1,0,2,0,0,0,0,0,2,0,0,2,2,2,0,2,0,0,0,0,0,2,0,0,2,2,2,3,0,2,0,1
1,0,2,2,2,2,0,2,2,2,0,2,0,0,0,2,2,2,2,2,2,2,0,0,2,0,0,0,0,2,2,1
1,2,2,0,0,2,0,2,0,2,2,2,0,0,0,0,0,0,0,0,2,0,0,2,2,0,0,0,0,0,2,1
1,2,0,0,0,2,2,2,0,0,0,2,0,0,0,0,0,0,0,0,2,0,0,2,0,0,2,2,2,0,2,1
1,2,3,0,0,2,0,0,0,2,2,2,2,0,0,2,2,2,2,0,2,2,0,2,2,2,2,0,2,0,2,1
1,0,2,2,2,2,0,0,0,2,0,0,2,0,0,2,0,0,2,0,0,2,0,0,0,0,0,0,2,2,2,1
1,0,0,2,0,0,0,0,0,2,0,0,2,2,0,2,0,0,2,0,2,-1,0,0,0,0,0,0,0,0,2,1
1,2,2,2,2,2,2,2,0,2,2,2,0,2,2,2,2,0,2,2,3,0,2,2,2,2,0,0,0,0,2,1
1,2,0,0,0,0,0,2,0,2,0,2,0,2,0,0,2,0,2,0,0,2,2,0,0,2,2,2,2,0,2,1
1,2,2,2,2,0,0,2,0,2,0,2,2,2,0,0,2,2,2,2,2,2,0,0,0,0,0,0,2,2,2,1
1,0,0,0,2,2,2,2,2,2,0,0,0,0,0,0,0,0,0,0,0,0,0,0,0,0,0,0,0,0,0,1
1,1,1,1,1,1,1,1,1,1,1,1,1,1,1,1,1,1,1,1,1,1,1,1,1,1,1,1,1,1,1,1
30,6
30,4
1,5
1,4
1,6
1,7
3,2,420
7,6,21,18
1002,850,800,360,300,225,150,100,75,50,25,10
0