1,1,1,1,1,1,1,1,1,1,1,1,1,1,1,1,1,1,1,1,1,1,1,1,1,1,1,1,1,1,1,1
1,4,1,2,2,2,0,2,2,2,2,2,0,2,2,2,2,2,2,0,2,2,2,2,2,0,2,2,2,1,4,1
1,1,1,2,0,2,0,2,0,0,0,2,0,2,0,-1,-1,0,2,0,2,0,0,0,2,0,2,0,2,1,1,1
1,2,2,2,0,2,2,2,2,2,2,2,2,2,0,-1,-1,0,2,2,2,2,2,2,2,2,2,0,2,2,2,1
1,2,0,0,0,0,0,0,0,6,0,0,0,0,0,0,0,0,0,0,0,0,0,0,0,0,0,0,0,0,2,1
1,2,2,2,2,0,2,2,2,5,2,2,2,2,2,2,2,2,2,2,2,2,2,2,2,2,0,2,2,2,2,1
1,0,0,0,2,0,2,0,2,0,0,0,0,2,0,0,0,0,2,0,0,0,0,2,0,2,0,2,0,0,0,1
1,2,2,2,2,0,2,0,2,2,2,2,2,2,2,2,2,2,2,2,2,2,2,2,0,5,6,2,2,2,2,1
1,2,0,0,0,0,2,0,2,0,0,0,0,0,0,2,2,0,0,0,0,0,0,2,0,2,0,0,0,0,2,1
1,2,2,2,2,0,2,2,2,0,2,2,2,2,0,2,2,0,2,2,2,2,0,2,2,2,0,2,2,2,2,1
1,2,0,0,2,0,2,0,2,0,2,0,0,2,0,6,6,0,2,0,0,2,0,2,0,2,0,2,0,0,2,1
1,2,6,3,2,0,2,0,2,0,2,0,0,2,2,-1,-1,2,2,0,0,2,0,2,0,2,0,2,3,6,2,1
1,2,0,0,2,0,2,2,2,0,2,2,2,2,0,2,2,0,2,2,2,2,0,2,2,2,0,2,0,0,2,1
1,2,2,2,2,6,5,0,2,0,0,0,0,0,0,2,2,0,0,0,0,0,0,2,0,2,0,2,2,2,2,1
1,0,0,0,2,0,2,0,2,2,2,2,2,2,2,2,2,2,2,2,2,2,2,2,0,2,0,2,0,0,0,1
1,2,2,2,2,0,2,0,2,0,0,0,0,2,0,0,0,0,2,0,0,0,0,2,0,2,0,2,2,2,2,1
1,2,0,0,0,0,2,2,2,2,2,2,2,2,2,2,2,2,2,2,2,5,2,2,2,2,0,0,0,0,2,1
1,2,2,2,2,0,0,0,0,0,0,0,0,0,0,0,0,0,0,0,0,6,0,0,0,0,0,2,2,2,2,1
1,0,0,0,2,0,2,2,2,2,2,2,2,2,2,2,2,2,2,2,2,2,2,2,2,2,0,2,0,0,0,1
1,2,2,0,2,0,2,0,2,0,0,0,0,-1,0,0,0,0,-1,0,0,0,0,2,0,2,0,2,0,2,2,1
1,2,2,2,2,2,2,0,2,0,2,2,2,2,2,2,2,2,2,2,2,2,0,2,0,2,2,2,2,2,2,1
1,1,1,2,0,0,0,0,2,0,2,0,0,0,2,0,0,2,0,0,0,2,0,2,0,0,0,0,2,1,1,1
1,4,1,2,2,2,2,2,2,0,2,2,2,2,2,2,2,2,2,2,2,2,0,2,2,2,2,2,2,1,4,1
1,1,1,1,1,1,1,1,1,1,1,1,1,1,1,1,1,1,1,1,1,1,1,1,1,1,1,1,1,1,1,1
18,19
13,19
16,3
15,3
16,2
15,2
3,2,300
15,11,16,11
1002,940,860,330,275,200,150,125,125,50,30,16
2
1,19,2,2,22,0
30,19,2,29,22,0