1,1,1,1,1,1,1,1,1,1,1,1,1,1,1,1,1,1,1,1,1,1,1,1,1,1,1,1,1,1,1,1
1,4,1,2,2,2,2,2,2,2,2,2,2,2,2,2,2,2,2,2,2,2,2,2,2,2,2,2,2,1,4,1
1,5,1,2,1,1,2,6,6,6,6,6,6,6,6,6,6,6,3,6,6,6,6,6,6,2,1,1,2,1,5,1
1,-1,1,2,1,2,6,6,-1,3,6,-1,3,6,6,3,6,-1,6,6,-1,3,6,6,-1,6,2,1,2,1,-1,1
1,2,1,2,1,2,6,3,6,6,6,3,6,6,6,-1,3,6,3,6,3,6,-1,3,6,6,2,1,2,1,2,1
1,2,1,2,1,2,6,6,3,6,-1,6,-1,6,3,6,6,6,6,3,-1,6,6,6,3,6,2,1,2,1,2,1
-1,2,1,2,1,2,6,6,6,0,0,0,0,0,0,0,0,0,0,0,0,0,0,6,6,6,2,1,2,1,2,-1
1,2,1,2,2,2,2,6,6,0,2,2,2,2,2,2,2,2,2,2,2,2,0,6,6,2,2,2,2,1,2,1
1,2,1,2,1,1,2,2,2,0,2,0,0,0,0,2,2,0,0,0,0,2,0,2,2,2,1,1,2,1,2,1
1,2,1,2,1,1,2,2,2,0,2,0,2,2,0,0,0,0,2,2,0,2,0,2,2,2,1,1,2,1,2,1
1,2,1,2,1,1,2,0,0,0,2,0,2,3,6,2,2,6,3,2,0,2,0,0,0,2,1,1,2,1,2,1
1,-1,1,2,1,1,2,2,2,2,2,0,0,0,0,2,2,0,0,0,0,2,2,2,2,2,1,1,2,1,-1,1
1,2,1,2,1,1,2,0,2,0,2,2,2,2,2,2,2,2,2,2,2,2,0,2,0,2,1,1,2,1,2,1
1,2,1,2,2,2,2,0,2,0,2,2,2,2,2,0,0,2,2,2,2,2,0,2,0,2,2,2,2,1,2,1
1,2,1,2,1,1,2,0,3,2,2,2,2,2,0,2,2,0,2,2,2,2,2,3,0,2,1,1,2,1,2,1
1,2,1,2,1,1,2,0,0,0,2,2,2,0,2,3,3,2,0,2,2,2,0,0,0,2,1,1,2,1,2,1
1,2,1,2,2,2,2,2,-1,0,2,2,2,2,2,2,2,2,2,2,2,2,0,-1,2,2,2,2,2,1,2,1
2,2,1,2,1,2,1,1,2,0,2,2,0,0,0,0,0,0,0,0,2,2,0,2,1,1,2,1,2,1,2,-1
1,2,1,2,1,2,1,1,2,0,2,6,3,2,2,2,2,2,2,3,6,2,0,2,1,1,2,1,2,1,2,1
1,2,1,2,1,2,1,1,2,0,2,2,0,0,0,0,0,0,0,0,2,2,0,2,1,1,2,1,2,1,2,1
1,-1,1,2,1,2,2,1,2,0,3,2,2,2,2,2,2,2,2,2,2,3,0,2,1,2,2,1,2,1,-1,1
1,5,1,2,1,1,2,1,2,3,0,0,0,0,0,0,0,0,0,0,0,0,3,2,1,2,1,1,2,1,5,1
1,4,1,2,2,2,2,2,2,2,2,2,2,2,2,2,2,2,2,2,2,2,2,2,2,2,2,2,2,1,4,1
1,1,1,1,1,1,1,1,1,1,1,1,1,1,1,1,1,1,1,1,1,1,1,1,1,1,1,1,1,1,1,1
1,11
30,11
30,3
1,3
30,20
1,20
3,2,300
8,16,23,16
1002,900,800,400,350,250,175,125,100,50,20,10
2
1,12,2,2,14,0
1,13,2,29,11,0