1,1,1,1,1,1,1,1,1,1,1,1,1,1,1,1,1,1,1,1,1,1,1,1,1,1,1,1,1,1,1,1
1,2,2,1,3,2,2,2,2,2,2,2,2,2,2,2,2,2,2,2,2,2,2,2,2,2,2,2,2,2,-1,1
1,2,2,1,2,2,0,0,0,0,0,0,0,0,0,0,0,0,0,0,0,0,0,0,0,0,0,0,0,0,2,1
1,2,2,1,1,1,2,2,2,2,2,2,2,2,2,2,2,2,2,2,2,2,2,2,2,2,2,2,2,0,2,1
1,1,2,2,1,1,2,2,0,0,0,0,0,0,0,2,0,2,0,2,0,0,0,0,0,0,0,0,2,0,2,1
1,2,2,2,2,1,1,2,2,2,2,2,2,3,0,2,0,2,0,2,0,3,2,2,2,2,2,2,2,0,2,1
1,2,0,0,2,0,1,1,2,2,0,0,2,2,0,2,0,2,0,2,0,2,0,0,0,0,2,0,2,0,2,1
1,2,0,2,2,2,2,1,1,2,2,0,0,2,2,2,2,2,2,2,2,2,0,-1,-1,0,2,0,2,0,2,1
1,2,0,-1,2,0,2,2,1,1,2,2,0,2,0,0,2,0,2,0,2,2,2,2,2,2,2,0,2,0,2,1
1,2,0,0,0,0,0,2,2,1,1,2,2,2,0,0,2,0,2,0,0,0,0,0,0,0,2,0,2,0,2,1
1,2,0,2,2,2,2,2,2,2,1,1,2,2,0,0,2,0,2,2,2,2,2,2,2,2,2,2,2,0,2,1
1,2,2,2,0,0,0,0,0,2,2,1,1,2,2,0,2,0,0,0,0,0,0,0,0,0,0,0,2,0,2,1
1,1,1,2,2,2,2,2,2,2,2,2,1,1,2,2,2,2,2,2,2,2,2,2,2,2,2,0,2,0,2,1
1,2,2,2,1,1,1,1,2,1,1,2,2,1,1,1,2,2,0,0,0,0,0,0,0,0,2,0,2,0,2,1
1,2,0,1,1,2,2,2,2,2,1,1,2,2,1,1,1,2,2,2,2,2,2,2,0,0,2,0,2,0,2,1
1,2,2,1,2,2,0,0,0,2,2,2,1,2,0,0,1,1,1,1,1,1,1,2,2,2,2,0,2,0,2,1
1,1,2,1,2,2,2,3,0,2,2,2,1,2,0,0,2,2,2,2,2,2,1,1,1,2,2,0,2,0,2,1
1,1,2,1,1,1,2,2,0,2,1,1,2,2,0,0,2,2,1,1,1,2,2,2,1,1,2,2,2,0,2,1
1,2,2,2,2,1,1,2,2,2,1,2,2,0,0,2,2,1,1,2,2,2,0,2,2,1,1,-1,-1,0,2,1
1,2,0,0,2,2,1,1,1,1,1,2,0,2,2,2,1,1,2,2,0,2,0,2,2,2,1,1,0,0,2,1
1,2,2,0,0,2,0,2,2,2,2,2,0,3,-1,1,1,2,2,0,0,2,0,2,0,2,2,1,1,0,2,1
1,2,2,0,2,2,2,2,0,2,0,2,1,1,1,1,1,2,0,0,0,2,0,2,0,0,2,2,1,2,2,1
1,2,2,2,2,1,1,1,1,2,2,2,2,2,2,2,2,2,2,2,2,-1,0,2,2,2,2,2,1,2,3,1
1,1,1,1,1,1,1,1,1,1,1,1,1,1,1,1,1,1,1,1,1,1,1,1,1,1,1,1,1,1,1,1
27,18
28,18
30,1
14,20
24,7
23,7
3,2,330
3,8,21,22
1002,880,800,350,300,200,125,75,50,15,0,0
3
6,3,2,5,3,0
29,1,2,31,1,0
27,22,2,0,22,0