1,1,1,1,1,1,1,1,1,1,1,1,1,1,1,1,1,1,1,1,1,1,1,1,1,1,1,1,1,1,1,1
1,2,2,2,2,2,2,2,2,2,2,2,2,2,2,1,1,1,2,2,2,2,2,2,2,2,2,2,2,2,2,1
1,2,-1,1,1,1,2,1,1,1,1,2,1,1,2,2,2,2,2,1,1,1,1,1,1,1,1,1,2,-1,2,1
1,2,-1,1,1,1,2,1,1,1,1,2,1,1,2,1,1,1,2,2,2,2,2,2,2,2,2,2,2,-1,2,1
1,2,1,1,1,1,2,2,2,2,2,2,2,2,2,1,1,1,2,1,1,1,1,2,1,1,1,1,2,1,2,1
1,2,1,1,2,2,2,1,1,1,2,1,1,1,2,2,2,1,2,1,1,1,1,2,1,1,1,1,2,1,2,1
1,2,2,2,2,1,1,2,2,2,2,2,2,2,1,1,2,2,2,2,1,1,1,2,1,1,1,1,2,1,2,1
1,2,2,1,1,2,2,2,0,0,0,0,0,2,2,2,2,1,1,2,2,2,1,2,2,2,2,2,2,1,2,1
1,2,1,2,2,2,0,0,5,5,2,2,2,0,0,0,2,2,2,1,1,2,2,2,1,1,1,1,2,1,2,1
1,2,2,2,0,0,2,2,2,2,2,2,2,2,2,2,0,0,2,2,2,1,1,2,1,1,1,1,2,2,2,1
1,2,0,0,2,2,2,2,2,2,2,2,2,2,2,2,2,2,0,0,2,2,2,2,1,1,1,1,2,1,2,1
1,2,0,0,2,2,2,2,2,2,2,2,0,0,2,2,2,2,2,2,0,0,2,2,2,1,1,2,2,1,2,1
1,2,0,0,0,0,0,0,0,0,0,0,2,2,0,2,2,2,2,2,2,-1,0,0,2,2,2,2,1,1,2,1
1,2,2,2,2,2,2,2,2,2,2,6,-1,2,0,2,2,2,2,2,2,2,2,2,0,0,0,2,2,2,2,1
1,2,2,2,0,0,0,0,0,0,0,0,2,2,0,2,2,2,2,2,2,2,2,2,2,2,2,0,0,2,2,1
1,2,0,0,3,2,2,2,2,2,2,2,0,0,2,2,2,2,2,2,2,2,2,2,2,2,2,2,2,0,2,1
1,2,0,0,2,2,2,2,2,2,2,2,2,2,2,2,2,2,2,2,2,2,2,2,2,2,2,2,3,0,2,1
1,2,0,0,0,0,0,0,0,0,0,0,0,0,0,0,0,0,0,0,0,0,0,0,0,0,0,0,0,0,2,1
1,2,2,2,2,2,2,2,2,6,3,6,2,2,2,2,2,2,2,2,2,6,3,6,2,2,2,2,2,2,2,1
1,2,1,1,1,1,2,0,0,0,2,0,0,2,1,1,1,1,2,0,0,0,2,0,0,2,1,1,1,1,2,1
1,2,1,1,1,1,2,6,2,2,-1,2,6,2,1,1,1,1,2,6,2,2,-1,2,6,2,1,1,1,1,2,1
1,2,1,1,1,1,2,0,0,0,0,0,0,2,1,1,1,1,2,0,0,0,0,0,0,2,1,1,1,1,2,1
1,2,2,2,2,2,2,2,2,2,2,2,2,2,2,2,2,2,2,2,2,2,2,2,2,2,2,2,2,2,2,1
1,1,1,1,1,1,1,1,1,1,1,1,1,1,1,1,1,1,1,1,1,1,1,1,1,1,1,1,1,1,1,1
2,2
29,2
22,20
10,20
29,3
2,3
3,2,400
12,13,21,12
1002,900,800,300,250,150,75,25,0,0,0,0
2
13,12,2,10,17,0
13,14,2,22,17,0