1,1,1,1,1,1,1,1,1,1,1,1,1,1,1,1,1,1,1,1,1,1,1,1,1,1,1,1,1,1,1,1
1,-1,2,0,2,2,2,2,2,2,2,2,2,2,2,2,2,2,2,2,2,2,2,2,2,2,2,2,0,2,-1,1
1,2,2,0,2,0,0,0,0,0,0,2,0,2,0,0,0,0,2,0,0,2,0,2,0,0,0,2,0,2,2,1
1,0,0,0,2,0,3,2,2,2,2,2,0,2,0,2,2,2,2,2,0,2,0,2,2,3,0,2,0,0,0,1
1,2,2,2,2,2,2,2,0,0,0,0,0,2,0,2,0,0,0,2,0,2,0,0,0,2,0,2,2,2,2,1
1,2,0,0,0,2,0,2,2,2,2,2,2,2,2,2,2,2,0,2,0,2,2,2,0,2,2,2,0,0,2,1
1,2,0,2,2,2,0,2,0,0,0,0,2,0,2,0,0,2,0,2,0,2,0,2,0,0,0,2,0,2,2,1
1,2,0,2,0,0,0,2,2,2,2,0,2,0,2,2,0,2,2,2,0,2,0,2,2,2,0,2,0,2,1,1
1,2,2,2,2,2,2,2,0,0,2,2,2,0,0,2,2,2,0,2,2,2,2,2,0,2,2,2,2,2,1,1
1,0,0,0,2,0,0,0,0,0,0,0,0,0,0,0,0,0,0,0,0,0,0,0,0,0,0,2,0,0,0,1
1,2,2,0,2,0,2,2,2,0,2,2,2,0,0,0,2,2,2,2,2,2,2,2,2,-1,0,2,0,2,2,1
1,2,2,0,2,0,2,0,2,0,2,0,2,2,2,0,2,0,2,0,0,2,0,0,0,2,0,2,0,2,2,1
1,2,2,0,2,0,2,0,2,0,2,0,0,0,2,0,2,0,2,0,0,2,2,2,0,2,0,2,0,2,2,1
1,-1,2,0,2,0,-1,2,2,2,2,2,2,2,2,2,2,0,2,2,2,2,0,2,2,2,0,2,0,2,-1,1
1,0,0,0,2,0,0,0,0,0,0,0,0,0,0,0,0,0,0,0,0,0,0,0,0,0,0,2,0,0,0,1
1,2,2,2,2,2,2,2,0,0,2,2,2,0,0,2,2,2,0,2,2,2,2,2,0,2,2,2,2,2,1,1
1,2,0,2,0,0,0,2,2,2,2,0,2,0,2,2,0,2,2,2,0,2,0,2,2,2,0,2,0,2,1,1
1,2,0,2,2,2,0,2,0,0,0,0,2,0,2,0,0,2,0,2,0,2,0,2,0,0,0,2,0,2,2,1
1,2,0,0,0,2,0,2,2,2,2,2,2,2,2,2,2,2,0,2,0,2,2,2,0,2,2,2,0,0,2,1
1,2,2,2,2,2,2,2,0,0,0,0,0,2,0,2,0,0,0,2,0,2,0,0,0,2,0,2,2,2,2,1
1,0,0,0,2,0,3,2,2,2,2,2,0,2,0,2,2,2,2,2,0,2,0,2,2,3,0,2,0,0,0,1
1,2,2,0,2,0,0,0,0,0,0,2,0,2,0,0,0,0,2,0,0,2,0,2,0,0,0,2,0,2,2,1
1,-1,2,0,2,2,2,2,2,2,2,2,2,2,2,2,2,2,2,2,2,2,2,2,2,2,2,2,0,2,-1,1
1,1,1,1,1,1,1,1,1,1,1,1,1,1,1,1,1,1,1,1,1,1,1,1,1,1,1,1,1,1,1,1
6,13
25,10
1,1
1,22
30,1
30,22
3,2,325
1,13,30,13
1002,800,700,380,325,225,150,100,75,50,25,10
8
1,3,1,0,0,33
30,3,1,0,0,66
2,9,1,0,0,100
29,9,1,0,0,133
26,10,1,0,0,166
5,13,1,0,0,200
1,20,1,0,0,233
30,20,1,0,0,266