1,1,1,1,1,1,1,1,1,1,1,1,1,1,1,1,1,1,1,1,1,1,1,1,1,1,1,1,1,1,1,1
1,2,2,2,2,2,2,2,2,2,2,2,2,2,2,2,2,2,2,2,2,1,4,1,2,2,2,2,2,2,2,1
1,2,0,0,2,0,2,0,2,0,0,2,0,0,2,0,0,0,2,0,2,1,5,1,2,0,0,2,0,2,2,1
1,2,0,-1,2,0,2,0,2,2,0,2,2,3,2,0,2,2,2,0,2,1,2,1,2,2,2,2,0,3,0,1
1,2,0,2,0,0,2,2,0,2,0,0,0,0,2,0,2,0,0,0,2,1,2,2,1,0,0,2,2,2,2,1
1,2,0,2,2,2,0,2,0,2,0,0,2,2,2,2,2,2,2,2,2,1,1,2,2,2,2,2,0,0,2,1
1,2,2,2,0,2,0,2,0,2,2,2,2,0,0,0,0,0,0,2,2,1,1,2,1,0,0,2,2,0,2,1
1,2,0,0,0,2,0,2,2,0,0,0,0,2,2,2,2,2,2,0,2,2,1,2,2,1,0,0,2,2,2,1
1,2,2,2,2,2,2,0,2,2,2,2,2,2,1,1,1,1,2,2,0,2,2,1,2,1,2,2,2,0,2,1
1,2,0,0,0,0,2,0,2,1,1,1,1,1,1,2,2,2,1,2,2,0,2,1,2,1,2,0,2,2,2,1
1,2,0,0,2,2,2,1,2,1,1,2,2,2,2,2,1,2,2,1,2,0,2,1,2,1,2,2,2,0,0,1
1,2,2,2,2,1,1,2,2,2,2,2,1,1,1,1,1,1,2,1,2,2,2,1,2,1,1,1,1,1,1,1
1,1,1,1,1,2,2,2,1,2,1,1,2,2,2,2,2,1,2,2,1,2,2,1,2,1,1,2,2,2,1,1
-1,2,2,2,2,2,1,1,0,2,0,2,2,0,2,0,2,2,1,2,1,2,2,1,-1,1,2,2,1,2,2,-1
1,1,1,1,1,1,2,2,0,2,0,2,0,0,2,2,2,2,1,2,2,1,1,1,2,2,2,1,1,1,1,1
1,2,2,2,2,2,2,2,0,2,0,2,2,2,2,0,0,2,2,1,2,2,2,2,2,2,1,2,2,2,2,1
1,2,0,2,0,0,2,2,0,2,2,0,0,0,2,2,2,0,2,1,1,1,1,-1,1,1,2,2,0,0,2,1
1,2,0,2,0,2,2,0,0,0,2,2,2,2,-1,0,2,0,2,2,2,2,1,2,1,1,2,0,2,2,2,1
1,2,2,2,2,2,0,2,2,2,2,0,0,0,0,0,2,2,2,0,0,2,1,2,1,2,2,2,2,0,2,1
1,2,0,0,2,0,2,2,0,0,2,2,0,2,2,2,2,0,3,0,0,2,1,2,2,2,1,2,0,0,2,1
1,2,2,2,2,2,2,0,-1,-1,0,2,0,2,0,0,2,2,2,2,2,2,1,2,1,1,2,2,3,0,2,1
1,2,0,0,0,0,0,0,-1,-1,0,2,0,2,0,0,0,2,0,0,0,2,1,5,1,2,2,1,2,0,2,1
1,2,2,2,2,2,2,2,2,2,2,2,2,2,2,2,2,2,2,2,2,2,1,4,1,2,2,2,2,2,2,1
1,1,1,1,1,1,1,1,1,1,1,1,1,1,1,1,1,1,1,1,1,1,1,1,1,1,1,1,1,1,1,1
23,16
24,13
8,20
9,20
8,21
9,21
3,2,350
3,3,14,17
1002,930,860,550,500,375,275,200,125,150,120,40
0