1,1,1,1,1,1,1,1,1,1,1,1,1,1,1,1,1,1,1,1,1,1,1,1,1,1,1,1,1,1,1,1
1,-1,-1,1,1,1,1,2,2,2,1,2,2,2,1,2,2,2,1,2,2,2,1,2,2,2,1,1,1,-1,-1,1
1,2,2,2,2,2,2,2,0,2,2,2,0,2,2,2,0,2,2,2,0,2,2,2,0,2,2,2,2,2,2,1
1,1,1,1,2,0,0,0,0,0,0,0,0,0,6,0,0,0,0,6,0,0,0,0,0,0,0,2,1,1,1,1
1,1,2,2,2,6,6,6,6,6,6,6,6,0,6,0,0,6,6,6,6,6,6,6,6,6,6,2,2,2,2,1
1,2,3,0,2,0,0,6,0,0,0,0,6,0,6,6,6,6,0,6,0,0,0,0,0,6,0,2,0,0,2,1
1,2,0,0,2,0,0,6,0,6,6,6,6,0,6,0,0,6,0,6,0,0,6,6,6,6,0,2,0,0,2,1
1,2,2,2,2,0,0,6,0,6,0,0,0,0,6,0,6,6,0,6,0,0,6,0,0,0,0,2,0,0,2,1
1,1,2,0,2,0,0,6,0,6,0,6,6,6,6,0,6,0,0,6,6,0,6,6,6,0,0,2,2,3,2,1
1,2,2,0,2,0,0,6,0,6,0,6,0,0,6,0,6,0,0,0,6,0,0,0,6,0,0,2,0,0,2,1
1,2,0,0,2,0,0,6,0,6,6,6,0,0,6,0,6,6,0,6,6,0,0,6,6,0,0,2,2,2,2,1
1,2,2,2,2,0,0,6,0,0,0,0,0,6,6,0,0,6,0,6,0,0,0,6,0,0,0,2,0,0,2,1
1,2,0,0,2,0,0,6,6,6,6,6,6,6,0,6,6,6,0,6,6,6,0,6,0,0,0,2,2,2,2,1
1,2,2,2,2,0,0,0,6,0,0,0,0,6,-1,6,0,0,0,0,0,6,0,6,0,0,0,2,0,0,2,1
1,2,0,0,2,0,0,0,6,0,6,6,6,6,0,6,6,0,0,0,0,6,0,6,6,6,6,2,0,2,2,1
1,2,2,2,2,6,6,6,6,0,6,0,0,0,0,0,6,0,6,6,6,6,0,0,0,6,0,2,0,2,1,1
1,2,0,0,2,0,0,6,0,0,6,0,6,6,6,6,6,6,6,0,0,0,6,6,6,6,0,2,2,2,2,1
1,2,0,0,2,0,0,6,0,0,6,0,6,0,0,0,0,0,6,0,0,0,6,0,0,0,0,2,0,0,2,1
1,2,0,0,2,2,2,2,2,2,2,2,2,2,2,2,2,2,2,2,2,2,2,2,2,2,2,2,0,3,2,1
1,2,2,2,2,0,0,0,2,0,0,0,0,0,0,0,2,0,0,0,0,2,0,0,0,2,0,2,2,2,1,1
1,1,1,1,2,2,3,0,2,2,2,2,2,2,2,2,2,2,-1,0,0,2,0,2,2,2,0,2,1,1,1,1
1,2,2,2,2,0,2,0,2,0,0,0,0,2,0,0,2,1,2,2,0,2,0,2,0,0,0,2,2,2,2,1
1,-1,2,1,2,2,2,2,2,2,2,2,2,2,2,2,2,1,1,2,2,2,2,2,2,2,2,2,1,2,-1,1
1,1,1,1,1,1,1,1,1,1,1,1,1,1,1,1,1,1,1,1,1,1,1,1,1,1,1,1,1,1,1,1
1,22
30,22
2,1
29,1
1,1
30,1
3,2,450
14,13,18,20
1002,900,800,300,275,175,100,50,25,10,0,0
2
3,21,2,0,22,0
28,21,2,31,22,0