1,1,1,1,1,1,1,1,1,1,1,1,1,1,1,1,1,1,1,1,1,1,1,1,1,1,1,1,1,1,1,1
1,3,2,2,2,2,2,2,2,2,2,2,2,2,2,2,0,0,0,2,2,2,2,2,2,2,2,2,2,2,3,1
1,2,0,0,2,0,2,0,0,0,0,2,0,0,0,-1,2,2,2,-1,0,0,2,0,0,2,0,0,2,0,2,1
1,2,0,0,2,0,2,0,0,0,0,2,0,0,0,0,0,2,0,0,0,2,2,0,0,2,0,2,2,0,2,1
1,2,0,0,2,0,2,2,2,2,0,2,0,0,0,2,2,2,2,2,2,2,0,0,0,2,0,2,0,0,2,1
1,2,0,0,2,0,2,0,0,2,0,2,2,2,2,2,0,0,0,0,2,0,0,0,0,2,2,2,0,0,2,1
1,2,2,2,2,0,2,0,0,2,0,2,0,0,0,2,0,0,0,0,2,0,0,0,0,2,0,2,2,0,2,1
1,2,0,0,0,0,2,0,0,2,0,2,0,0,0,2,0,0,0,0,2,0,0,2,2,2,0,0,2,0,2,1
1,2,2,2,2,2,2,2,2,2,2,2,0,0,0,2,0,0,0,0,2,0,0,2,0,0,0,2,2,2,2,1
1,2,0,0,0,0,0,0,0,0,0,2,0,0,0,2,2,2,2,2,2,0,0,2,0,2,2,2,0,0,2,1
1,2,0,0,2,2,2,2,2,2,2,2,0,0,0,2,0,0,0,0,2,0,0,2,0,2,0,0,0,0,2,1
1,2,0,0,2,0,0,2,0,0,0,2,0,0,0,2,0,0,0,0,2,2,2,2,2,2,2,2,2,2,2,1
1,2,2,2,2,0,0,2,-1,-1,0,2,2,2,2,2,2,2,0,0,2,0,0,0,2,0,0,0,0,0,2,1
1,2,0,0,2,0,0,2,-1,-1,0,2,0,0,0,0,0,2,0,0,2,0,0,0,2,2,0,0,0,0,2,1
1,2,0,0,2,0,0,2,0,0,0,2,0,0,0,0,0,2,-1,-1,2,2,0,0,0,2,-1,-1,0,0,2,1
1,2,0,2,2,2,2,2,2,2,2,2,2,2,2,2,2,2,0,0,0,2,0,0,0,2,-1,-1,0,0,2,1
1,2,0,2,0,0,0,0,2,2,0,0,0,0,0,0,2,0,0,0,0,2,2,2,2,2,0,0,0,0,2,1
1,2,0,2,0,0,0,0,0,0,0,0,2,2,2,0,2,0,0,0,0,2,0,0,0,2,2,2,2,2,2,1
1,2,2,2,2,2,2,2,2,2,2,2,2,0,2,2,2,0,0,0,0,2,0,0,0,0,2,0,0,0,2,1
1,2,0,0,0,0,2,0,2,0,0,0,2,0,0,0,2,0,0,0,0,2,0,0,2,2,2,2,2,0,2,1
1,2,0,0,0,0,2,0,2,2,2,0,2,0,0,0,2,2,2,2,2,2,0,0,2,0,0,0,2,0,2,1
1,2,0,0,0,0,2,0,0,0,2,0,2,0,0,0,2,0,0,0,0,0,0,0,2,0,0,0,2,0,2,1
1,3,2,2,2,2,2,2,2,2,2,2,2,2,2,2,2,2,2,2,2,2,2,2,2,2,2,2,2,2,3,1
1,1,1,1,1,1,1,1,1,1,1,1,1,1,1,1,1,1,1,1,1,1,1,1,1,1,1,1,1,1,1,1
15,2
19,2
9,12
9,13
27,14
27,15
3,2,540
19,14,19,14
1002,920,840,400,300,225,175,150,125,120,90,45
0   //2, 540