1,1,1,1,1,1,1,1,1,1,1,1,1,1,1,1,1,1,1,1,1,1,1,1,1,1,1,1,1,1,1,1
1,1,1,6,5,4,6,6,6,1,1,4,5,6,6,6,1,6,6,5,4,6,6,6,1,6,6,5,4,1,1,1
1,1,1,6,1,1,6,1,6,1,1,1,1,1,1,6,1,6,1,1,1,6,1,6,1,6,1,1,6,6,6,1
1,1,1,6,6,6,6,1,6,6,6,1,6,6,6,6,1,6,6,6,6,6,1,6,1,6,6,6,6,1,6,1
1,1,1,1,1,1,1,1,1,1,6,1,6,1,1,1,1,1,1,1,1,1,1,6,1,1,1,1,1,1,6,1
1,2,2,2,2,2,2,2,2,2,2,2,2,2,2,2,2,2,2,2,2,2,2,2,2,2,2,2,2,2,2,1
1,2,0,0,0,0,0,2,0,2,2,0,2,2,0,2,2,0,2,2,0,2,2,0,2,0,0,0,0,0,2,1
1,2,3,2,2,2,0,2,2,2,0,2,2,0,2,2,0,2,2,0,2,2,0,2,2,0,2,2,2,3,2,1
1,2,0,0,0,2,0,2,2,0,2,2,0,2,2,2,2,2,0,2,2,0,2,2,2,0,2,0,0,0,2,1
1,2,-1,2,0,2,2,2,0,2,2,2,2,2,0,2,2,0,2,2,2,2,2,0,2,2,2,0,2,-1,2,1
1,2,0,2,0,2,0,2,2,2,0,2,2,0,-1,-1,0,2,2,0,2,2,0,2,2,0,2,0,2,0,2,1
1,2,0,2,0,2,0,2,-1,0,2,2,0,2,-1,-1,2,2,0,2,2,0,2,2,2,0,2,0,2,0,2,1
1,2,2,2,0,2,2,2,0,2,2,2,2,2,0,2,2,0,2,2,0,2,2,0,2,2,2,0,2,2,2,1
1,2,0,0,0,2,0,2,2,2,0,2,2,0,2,2,0,2,2,0,2,2,0,-1,2,0,2,0,0,0,2,1
1,2,3,2,2,2,0,2,2,0,2,2,0,2,2,2,2,2,0,2,2,0,2,2,2,0,2,2,2,3,2,1
1,2,0,0,0,0,0,2,0,2,2,0,2,2,0,2,2,0,2,2,0,2,2,0,2,0,0,0,0,0,2,1
1,2,2,2,2,2,2,2,2,2,2,2,2,2,2,2,2,2,2,2,2,2,2,2,2,2,2,2,2,2,2,1
1,1,6,1,1,1,1,1,1,1,1,1,1,1,1,1,1,6,1,1,1,1,1,1,1,1,1,1,1,1,1,1
1,6,6,1,1,6,6,6,6,6,6,6,6,6,6,1,6,6,1,6,6,6,6,6,6,1,6,6,6,6,6,1
1,6,1,1,6,6,1,1,1,1,1,1,1,1,6,1,6,1,6,6,1,1,1,1,6,6,6,1,1,1,6,1
1,6,6,1,6,1,1,6,6,6,6,6,6,1,6,1,6,1,6,1,6,6,6,1,1,1,1,1,6,6,6,1
1,1,6,6,6,1,1,6,1,1,1,1,6,1,6,1,6,1,6,1,6,1,6,1,6,6,6,1,6,1,1,1
1,1,1,1,1,1,1,6,6,6,4,1,6,6,6,1,6,6,6,1,4,1,6,6,6,1,6,6,6,1,1,1
1,1,1,1,1,1,1,1,1,1,1,1,1,1,1,1,1,1,1,1,1,1,1,1,1,1,1,1,1,1,1,1
29,9
2,9
15,10
15,11
14,10
14,11
3,2,300
8,11,23,13
1002,800,770,350,300,200,175,150,150,75,60,25
0