1,1,1,1,1,1,1,1,1,1,1,1,1,1,1,1,1,1,1,1,1,1,1,1,1,1,1,1,1,1,1,1
1,2,2,2,2,2,2,2,1,1,1,1,1,2,2,2,2,2,2,1,1,1,1,1,2,2,2,2,2,2,-1,1
1,2,0,0,0,0,0,2,2,2,2,2,2,2,1,1,1,1,2,2,2,2,2,2,2,0,0,0,0,0,2,1
1,2,2,2,2,2,2,2,2,2,2,0,0,2,2,-1,2,2,2,0,0,3,2,2,2,2,2,2,2,2,2,1
1,2,0,2,1,1,2,0,2,0,0,0,2,2,2,1,1,2,2,2,0,0,0,2,0,2,1,1,2,0,2,1
1,2,0,2,1,-1,2,0,2,2,2,2,2,2,2,1,1,2,2,2,2,2,2,2,0,2,2,1,2,0,2,1
1,2,0,2,2,2,0,0,2,0,2,2,0,0,2,0,0,2,2,1,1,2,0,2,0,0,2,2,2,0,2,1
1,2,2,2,0,0,0,2,2,0,2,2,0,0,2,0,2,2,1,1,2,2,0,2,2,0,0,0,2,2,2,1
1,1,2,2,2,2,2,2,0,0,2,0,0,2,2,2,2,1,2,2,2,2,0,0,2,2,2,2,2,2,1,1
1,1,2,0,2,0,0,0,0,3,2,0,2,2,1,1,1,1,2,2,0,2,2,0,0,0,0,2,0,2,1,1
1,1,2,0,2,2,2,2,2,2,2,2,2,1,2,2,2,2,1,2,2,2,2,2,2,2,2,2,0,2,1,1
1,1,2,0,2,1,1,2,0,0,0,0,2,1,-1,1,1,2,1,2,0,0,0,0,2,1,1,2,0,2,1,1
1,1,2,0,2,1,1,2,0,0,0,0,2,1,2,1,2,2,1,2,0,0,0,0,2,1,1,2,0,2,1,1
1,1,2,0,2,2,2,2,2,2,2,2,2,1,2,2,2,2,1,2,2,2,2,2,2,2,2,2,0,2,1,1
1,1,2,0,2,0,0,0,0,2,2,0,2,2,1,1,1,1,2,2,0,2,3,0,0,0,0,2,0,2,1,1
1,1,2,2,2,2,2,2,0,0,2,2,2,2,1,2,2,2,2,0,0,2,0,0,2,2,2,2,2,2,1,1
1,2,2,2,0,0,0,2,2,0,2,2,1,1,2,2,0,2,0,0,2,2,0,2,2,0,0,0,2,2,2,1
1,2,0,2,2,-1,0,0,2,0,2,2,1,1,2,0,0,2,0,0,2,2,0,2,0,0,2,2,2,0,2,1
1,2,0,2,1,2,-1,0,2,2,2,2,2,1,2,1,1,2,2,2,2,2,2,2,0,2,-1,1,2,0,2,1
1,2,0,2,1,1,2,0,2,0,0,0,2,2,2,1,1,2,2,2,0,0,0,2,0,2,1,1,2,0,2,1
1,2,2,2,2,2,2,2,2,2,3,0,0,2,2,2,-1,2,2,0,0,2,2,2,2,2,2,2,2,2,2,1
1,2,0,0,0,0,0,2,2,2,2,2,2,2,1,1,1,1,2,2,2,2,2,2,2,0,0,0,0,0,2,1
1,2,2,2,2,2,2,2,1,1,1,1,1,2,2,2,2,2,2,1,1,1,1,1,2,2,2,2,2,2,2,1
1,1,1,1,1,1,1,1,1,1,1,1,1,1,1,1,1,1,1,1,1,1,1,1,1,1,1,1,1,1,1,1
5,17
6,18
14,11
30,1
26,18
5,5
3,2,350
15,3,16,20
1002,900,850,425,375,275,200,150,125,90,45,15
2
7,7,2,13,10,0
24,16,2,18,13,0