1,1,1,1,1,1,1,1,1,1,1,1,1,1,1,1,1,1,1,1,1,1,1,1,1,1,1,1,1,1,1,1
1,2,2,2,2,2,2,2,2,2,2,2,2,2,2,0,0,2,2,2,2,2,2,2,2,2,2,2,2,2,2,1
1,2,0,0,2,0,2,3,0,2,0,0,2,0,2,2,2,2,0,2,0,0,2,0,3,2,0,2,0,0,2,1
1,2,0,2,2,0,2,0,0,2,0,2,2,0,2,0,0,2,0,2,2,0,2,0,0,2,0,2,2,0,2,1
1,2,0,2,0,0,2,2,2,2,2,2,0,0,2,0,0,2,0,0,2,2,2,2,2,2,0,0,2,0,2,1
1,2,0,2,0,2,2,0,2,0,0,2,0,2,2,0,0,2,2,0,2,0,0,2,0,2,2,0,2,0,2,1
1,2,2,2,2,2,0,0,2,0,2,2,2,2,2,0,0,2,2,2,2,2,0,2,0,0,2,2,2,2,2,1
1,0,2,0,0,2,2,2,2,0,2,0,0,2,2,-1,-1,2,2,0,0,2,0,2,2,2,2,0,0,2,0,1
1,0,2,0,2,2,0,2,0,0,2,0,2,2,0,2,2,0,2,2,0,2,0,0,2,0,2,2,0,2,0,1
1,2,2,2,2,0,0,2,2,2,2,0,2,0,0,2,2,0,0,2,0,2,2,2,2,0,0,2,2,2,2,1
1,2,0,0,2,2,2,2,0,2,0,0,2,2,2,2,2,2,2,2,0,0,2,0,2,2,2,2,0,0,2,1
1,2,0,2,2,0,-1,0,0,2,2,2,2,0,2,0,0,2,0,2,2,2,2,0,0,-1,0,2,2,0,2,1
1,2,0,2,0,0,-1,0,2,2,0,2,0,0,2,0,0,2,0,0,2,0,2,2,0,-1,0,0,2,0,2,1
1,2,0,2,0,2,2,2,2,0,0,2,0,2,2,0,0,2,2,0,2,0,0,2,2,2,2,0,2,0,2,1
1,2,2,2,2,2,0,0,2,0,2,2,2,2,2,0,0,2,2,2,2,2,0,2,0,0,2,2,2,2,2,1
1,0,2,0,0,2,0,2,2,2,2,0,0,2,2,2,2,2,2,0,0,2,2,2,2,0,2,0,0,2,0,1
1,0,2,0,2,2,0,2,0,0,2,0,2,2,0,2,2,0,2,2,0,2,0,0,2,0,2,2,0,2,0,1
1,2,2,0,2,0,0,2,0,2,2,0,2,0,0,2,2,0,0,2,0,2,2,0,2,0,0,2,0,2,2,1
1,2,0,0,2,2,2,2,2,2,0,0,2,0,2,-1,-1,2,0,2,0,0,2,2,2,2,2,2,0,0,2,1
1,2,2,2,2,0,2,0,0,2,0,2,2,0,2,0,0,2,0,2,2,0,2,0,0,2,0,2,2,2,2,1
1,2,0,2,0,0,2,0,3,2,2,2,0,0,2,0,0,2,0,0,2,2,2,3,0,2,0,0,2,0,2,1
1,2,0,2,0,2,2,0,2,0,0,2,0,2,2,0,0,2,2,0,2,0,0,2,0,2,2,0,2,0,2,1
1,2,2,2,2,2,2,2,2,2,2,2,2,2,2,2,2,2,2,2,2,2,2,2,2,2,2,2,2,2,2,1
1,1,1,1,1,1,1,1,1,1,1,1,1,1,1,1,1,1,1,1,1,1,1,1,1,1,1,1,1,1,1,1
6,11
25,11
15,7
16,18
16,7
15,18
3,2,295
6,12,25,12
1002,920,840,400,350,250,175,125,100,75,50,25
0