1,1,1,1,1,1,1,1,1,1,1,1,1,1,1,1,1,1,1,1,1,1,1,1,1,1,1,1,1,1,1,1
1,-1,2,2,2,0,2,2,2,2,2,2,2,2,2,-1,1,-1,2,0,0,0,2,2,2,2,2,2,2,2,2,1
1,2,0,0,2,0,2,0,0,0,0,2,0,0,0,2,1,2,2,2,2,2,2,0,0,0,2,0,0,0,2,1
1,2,2,0,2,2,2,2,2,2,2,2,2,2,0,2,1,2,0,0,2,0,2,0,2,2,2,2,2,2,2,1
1,1,2,0,0,0,0,0,2,0,0,0,0,2,2,2,1,2,2,2,2,2,2,0,2,0,0,0,2,0,2,1
1,1,2,2,2,2,2,2,2,2,0,2,2,2,0,2,1,2,0,0,2,0,2,2,2,2,2,2,2,0,2,1
1,2,2,2,0,2,2,0,2,2,2,2,0,0,0,2,1,2,0,2,2,2,2,0,0,0,0,2,0,0,2,1
1,2,0,0,0,2,0,0,2,0,0,2,2,2,2,2,1,2,0,2,0,0,2,-1,0,2,2,2,2,2,2,1
1,2,0,2,2,2,2,2,2,2,2,2,0,-1,0,2,1,2,0,2,2,2,2,2,2,2,0,2,0,0,2,1
1,2,0,2,0,2,0,0,0,0,0,2,0,6,0,2,1,2,0,0,2,0,0,2,0,0,0,2,2,2,2,1
1,2,3,2,0,2,2,2,2,2,2,2,2,2,2,2,1,2,2,2,2,2,2,2,2,2,2,2,6,2,1,1
1,1,1,1,1,1,1,1,1,1,1,1,1,1,1,1,1,1,1,1,1,1,1,1,1,1,1,1,1,1,1,1
1,2,6,2,2,2,2,2,2,2,2,2,1,2,2,2,1,2,2,2,2,2,0,2,2,2,2,2,2,2,1,1
1,2,2,2,0,0,0,2,0,2,0,2,2,2,0,2,1,2,0,0,0,2,2,2,0,2,0,2,0,3,1,1
1,2,0,2,0,2,2,2,0,2,0,0,0,2,0,2,1,2,2,2,0,2,0,2,2,2,0,2,0,2,2,1
1,2,0,2,0,2,0,2,0,2,2,2,0,2,0,2,1,2,0,2,0,2,0,0,0,0,0,2,0,0,2,1
1,2,0,2,2,2,2,2,0,0,0,2,2,2,0,2,1,2,2,2,0,2,2,2,2,2,2,2,2,2,2,1
1,2,2,2,0,0,0,2,0,2,2,2,0,2,2,2,1,2,0,0,0,2,0,2,0,2,0,0,0,2,2,1
1,2,0,2,0,2,2,-1,2,2,0,2,0,0,0,2,1,2,2,2,2,2,2,2,2,2,2,2,0,0,2,1
1,2,0,2,0,2,0,2,0,0,0,2,2,2,0,2,1,2,0,2,0,2,0,0,0,0,0,2,2,2,2,1
1,2,0,2,2,2,0,2,0,2,2,2,0,2,0,2,1,2,0,-1,2,2,0,2,2,2,0,2,0,0,2,1
1,2,0,0,2,0,0,2,0,2,0,0,0,2,0,2,1,2,0,0,0,2,0,2,0,2,0,2,0,2,2,1
1,2,2,2,2,2,2,2,2,2,2,2,2,2,3,2,1,2,2,2,2,2,2,2,2,2,2,2,2,2,-1,1
1,1,1,1,1,1,1,1,1,1,1,1,1,1,1,1,1,1,1,1,1,1,1,1,1,1,1,1,1,1,1,1
1,1
15,1
30,22
17,1
7,18
13,8
3,2,350
19,20,23,7
1002,930,860,440,400,300,250,200,170,140,125,75
3
15,10,2,1,11,0
2,12,2,16,22,0
23,12,2,29,11,0