1,1,1,1,1,1,1,1,1,1,1,1,1,1,1,1,1,1,1,1,1,1,1,1,1,1,1,1,1,1,1,1
1,2,2,2,2,2,2,2,2,2,2,2,2,2,2,2,2,2,2,2,2,2,2,2,2,2,2,2,2,2,2,1
1,2,1,1,1,1,1,1,1,1,1,1,1,1,1,2,0,2,0,0,0,0,2,0,2,0,2,0,0,0,2,1
1,2,1,2,2,2,2,2,2,2,2,2,2,2,1,2,0,2,0,0,2,2,2,0,2,0,2,0,0,0,2,1
1,2,1,2,1,1,1,1,1,1,1,1,1,2,1,2,0,2,2,2,2,0,2,0,2,0,2,2,2,2,2,1
1,2,1,2,1,3,2,2,1,2,2,2,1,2,1,2,0,2,0,0,0,0,2,2,2,2,-1,2,0,0,2,1
1,2,1,2,1,-1,2,2,2,2,1,2,1,2,1,2,2,2,0,2,2,0,2,0,0,2,0,2,2,2,2,1
1,2,1,2,1,1,1,1,1,1,1,2,1,2,1,2,0,2,0,2,2,2,2,2,0,2,0,2,0,0,2,1
1,2,1,2,2,2,2,2,2,2,2,2,1,2,1,2,0,2,2,2,0,0,0,2,0,2,0,2,2,2,2,1
1,2,1,1,1,1,1,1,1,1,1,1,1,2,1,2,0,2,0,2,2,2,2,2,0,2,0,2,0,0,2,1
1,2,2,2,2,2,2,2,2,2,2,2,2,2,1,2,2,2,0,-1,0,2,0,2,0,2,0,2,2,2,2,1
1,1,1,1,1,1,1,1,1,1,1,1,1,1,1,0,0,2,0,2,0,2,0,2,0,2,0,2,0,0,2,1
1,2,2,2,2,2,2,2,2,2,2,2,2,2,2,-1,2,2,0,2,2,2,2,2,2,2,2,2,2,2,2,1
1,2,0,0,0,0,2,0,0,0,0,0,0,2,0,2,0,1,1,1,1,1,1,1,1,1,1,1,1,1,1,1
1,2,0,2,2,2,2,0,2,2,2,-1,0,2,0,2,0,1,2,2,2,2,2,2,2,2,2,2,2,2,2,1
1,2,2,2,0,0,2,0,2,0,0,2,0,2,0,2,2,1,2,1,1,1,1,1,1,1,1,1,1,1,2,1
1,2,0,2,2,2,2,2,2,2,2,2,0,2,0,0,2,1,2,1,2,2,2,2,2,2,2,2,2,1,2,1
1,2,0,2,0,0,2,0,2,0,0,2,2,2,0,2,2,1,2,1,2,1,1,1,1,1,2,1,2,1,2,1
1,2,0,2,2,-1,2,0,2,2,2,2,0,2,2,2,0,1,2,1,2,2,-1,3,2,2,2,1,2,1,2,1
1,2,0,2,0,0,2,0,2,0,0,2,0,2,0,2,2,1,2,1,1,1,1,1,1,1,1,1,2,1,2,1
1,2,2,2,2,2,2,0,2,2,2,2,0,2,0,0,2,1,2,2,2,2,2,2,2,2,2,2,2,1,2,1
1,2,0,0,0,0,0,0,2,0,0,0,0,2,0,0,2,1,1,1,1,1,1,1,1,1,1,1,1,1,2,1
1,2,2,2,2,2,2,2,2,2,2,2,2,2,2,2,2,2,2,2,2,2,2,2,2,2,2,2,2,2,2,1
1,1,1,1,1,1,1,1,1,1,1,1,1,1,1,1,1,1,1,1,1,1,1,1,1,1,1,1,1,1,1,1
11,14
19,10
26,5
5,18
22,18
5,6
3,2,480
15,12,15,12
1002,930,860,400,350,250,175,125,100,75,50,25
0