1,1,1,1,1,1,1,1,1,1,1,1,1,1,1,1,1,1,1,1,1,1,1,1,1,1,1,1,1,1,1,1
1,2,2,2,2,2,2,2,2,2,1,2,2,2,2,1,2,2,2,1,2,2,2,1,2,2,2,1,2,-1,2,1
1,2,0,0,0,0,3,0,0,2,1,2,0,0,2,2,2,0,2,1,2,0,2,2,2,0,2,1,2,0,2,1
1,2,0,2,2,2,2,2,0,2,1,2,0,0,0,2,0,0,2,1,2,0,2,0,0,0,2,1,2,0,2,1
1,2,0,2,0,0,0,2,2,2,2,2,0,0,2,2,0,2,2,2,2,3,2,0,0,2,2,2,2,0,2,1
1,2,2,2,2,2,0,2,2,1,2,2,2,2,2,0,0,2,1,2,0,0,2,0,0,2,1,2,2,2,2,1
1,2,0,0,0,2,0,0,2,1,2,0,0,0,2,0,2,2,1,2,0,0,2,2,2,2,1,2,0,0,2,1
1,2,2,2,2,2,2,2,2,1,2,0,0,2,2,0,2,1,2,2,0,2,2,0,2,1,2,2,2,0,2,1
1,1,1,1,2,1,1,1,1,2,2,2,0,2,0,0,2,1,2,0,0,2,0,0,2,1,2,0,2,0,2,1
1,2,2,2,2,2,2,2,1,2,0,2,2,2,0,2,2,1,2,0,-1,-1,0,2,2,1,2,0,2,0,2,1
1,2,0,2,0,0,2,2,1,2,0,0,2,0,0,2,1,2,2,0,-1,-1,0,2,1,2,2,0,2,2,2,1
1,2,0,2,2,2,2,1,2,2,0,2,2,0,0,2,1,2,0,0,2,0,0,2,1,2,0,0,2,0,2,1
1,2,0,2,0,0,2,2,2,0,2,2,2,0,0,2,2,2,2,2,2,0,2,2,2,2,2,2,2,0,2,1
1,2,2,2,0,2,2,1,2,0,2,0,2,0,2,2,1,2,0,2,2,0,2,1,2,0,0,0,2,0,2,1
1,2,0,2,0,2,1,2,2,0,2,2,2,0,2,1,2,2,0,2,0,0,2,1,2,2,2,2,2,2,2,1
1,2,0,2,0,2,1,2,0,0,2,0,0,0,2,1,2,0,0,2,2,2,2,1,1,1,2,0,2,1,1,1
1,2,0,2,2,2,1,2,0,0,2,0,0,2,2,1,2,0,2,2,0,2,1,2,2,2,2,2,2,2,2,1
1,2,0,0,2,1,2,2,0,0,2,0,0,2,1,2,2,2,2,0,0,2,1,2,0,0,2,0,0,0,2,1
1,2,2,2,2,2,2,0,2,2,2,0,0,2,2,2,0,0,2,0,2,2,2,2,2,0,2,2,2,2,2,1
1,2,0,2,2,1,2,0,2,0,2,0,2,2,1,2,0,2,2,2,2,1,2,0,2,0,0,0,2,0,2,1
1,2,0,2,1,2,2,0,2,0,2,0,2,1,2,2,0,2,0,0,2,1,2,0,2,2,2,2,2,0,2,1
1,2,0,2,1,2,0,0,2,0,3,0,2,1,2,0,0,2,0,0,2,1,2,0,0,3,0,0,0,0,2,1
1,-1,-1,-1,1,2,2,2,2,2,2,2,2,1,2,2,2,2,2,2,2,1,2,2,2,2,2,2,2,2,2,1
1,1,1,1,1,1,1,1,1,1,1,1,1,1,1,1,1,1,1,1,1,1,1,1,1,1,1,1,1,1,1,1
1,22
3,22
21,10
20,10
21,9
20,9
3,2,450
2,22,29,1
1002,930,860,425,375,275,200,150,125,100,75,50
0