1,1,1,1,1,1,1,1,1,1,1,1,1,1,1,1,1,1,1,1,1,1,1,1,1,1,1,1,1,1,1,1
1,1,2,2,2,2,2,2,2,2,2,2,2,2,2,2,2,2,2,2,2,2,2,2,2,2,2,2,2,2,2,1
1,2,2,2,0,0,0,0,3,2,0,0,2,1,2,2,0,0,2,0,6,0,2,0,6,0,2,0,6,0,2,1
1,2,2,6,2,2,2,2,6,2,6,0,2,2,2,0,2,6,2,0,2,0,2,0,-1,0,2,0,2,0,2,1
1,2,2,0,2,-1,-1,2,0,2,2,0,2,2,0,2,2,0,2,0,2,0,2,0,2,0,2,0,2,0,2,1
1,2,0,2,2,0,0,2,2,6,2,0,2,6,2,2,2,0,2,0,2,0,2,0,2,0,2,0,2,0,2,1
1,2,0,2,0,-1,-1,0,2,0,2,0,2,0,2,-1,2,0,2,0,2,0,6,0,2,0,6,0,2,0,2,1
1,2,0,2,0,2,2,0,2,0,2,6,2,0,2,2,2,6,2,0,2,2,2,2,-1,2,2,2,2,0,2,1
1,2,6,2,2,2,2,2,2,0,2,0,2,2,0,2,2,0,2,0,0,0,6,0,2,2,0,6,0,0,2,1
1,2,2,0,0,2,2,0,0,2,2,2,6,2,0,2,2,0,2,2,2,2,2,0,2,2,0,2,2,2,2,1
1,2,2,2,0,2,2,0,2,2,0,2,0,2,0,2,2,0,2,1,2,1,2,0,2,2,0,2,1,1,2,1
1,2,1,2,0,2,2,0,2,0,0,2,0,2,0,2,2,0,2,1,2,1,2,6,2,2,6,2,1,1,2,1
1,2,1,2,0,2,2,0,2,0,0,2,0,2,2,0,2,6,2,2,2,2,2,0,2,2,0,2,2,2,2,1
1,2,1,2,6,2,2,0,2,0,0,2,0,3,2,0,2,0,2,1,2,1,2,0,2,2,0,2,1,1,2,1
1,2,1,2,0,2,2,0,2,0,2,2,0,2,2,6,2,0,2,1,2,1,2,0,2,2,0,2,1,1,2,1
1,2,1,2,0,2,2,0,2,6,2,0,0,2,2,0,2,0,2,1,2,1,2,0,2,2,0,2,2,2,2,1
1,2,2,2,0,2,2,0,2,0,2,0,2,2,2,0,2,6,2,1,2,1,2,0,2,2,0,2,1,1,2,1
1,2,1,2,6,2,2,6,2,0,2,2,2,0,2,0,2,0,2,2,3,2,2,0,2,2,6,2,1,1,2,1
1,2,1,2,0,2,2,0,2,0,2,0,2,-1,2,6,2,0,2,1,2,1,2,6,2,2,0,2,1,1,2,1
1,2,1,2,0,2,2,6,2,0,2,0,2,0,2,0,2,0,2,1,2,1,2,0,2,2,0,2,2,2,2,1
1,2,1,2,0,2,2,0,2,0,2,0,2,0,2,0,2,0,2,1,2,1,2,0,2,2,0,2,1,1,2,1
1,2,1,2,0,6,6,0,2,0,2,0,2,0,2,0,6,0,2,1,2,1,2,0,6,6,0,2,1,3,2,1
1,2,2,2,2,2,2,2,2,2,2,2,2,2,2,2,2,2,2,2,2,2,2,2,2,2,2,2,2,2,2,1
1,1,1,1,1,1,1,1,1,1,1,1,1,1,1,1,1,1,1,1,1,1,1,1,1,1,1,1,1,1,1,1
5,4
6,4
15,6
24,3
6,6
5,6
3,2,400
13,18,24,7
1002,955,910,425,375,300,225,175,150,60,50,25
0