1,1,1,1,1,1,1,1,1,1,1,1,1,1,1,1,1,1,1,1,1,1,1,1,1,1,1,1,1,1,1,1
1,2,2,2,2,2,2,2,2,2,2,1,1,2,2,2,2,2,2,1,1,2,2,2,2,2,2,2,2,2,2,1
1,2,1,2,1,1,1,2,1,1,2,2,2,2,0,0,0,0,2,2,2,2,1,1,2,1,1,1,2,1,2,1
1,2,1,2,2,2,2,2,2,2,2,0,0,0,-1,-1,2,-1,0,0,0,2,2,2,2,2,2,2,2,1,2,1
1,2,1,1,1,2,2,2,0,0,0,2,2,2,2,2,2,2,2,2,2,0,0,0,2,2,2,1,1,1,2,1
1,2,1,2,2,2,0,0,2,2,2,2,0,0,0,2,2,0,0,0,2,2,2,2,0,0,2,2,2,1,2,1
1,2,2,2,0,0,2,2,2,0,2,0,0,2,2,2,2,2,2,0,0,2,0,2,2,2,0,0,2,2,2,1
1,2,0,0,2,2,2,0,0,0,2,2,2,-1,0,2,0,0,2,2,2,2,0,0,0,2,2,2,0,0,2,1
1,2,0,2,2,0,2,0,2,2,2,0,2,0,0,2,0,0,0,2,0,2,2,2,0,2,0,2,2,0,2,1
1,2,0,2,0,0,2,2,2,0,0,0,2,0,0,2,0,0,0,2,0,0,0,2,2,2,0,0,2,0,2,1
1,2,0,2,2,2,2,2,2,2,2,2,2,2,2,2,2,2,2,2,2,2,2,2,2,2,2,2,2,0,2,1
1,2,0,2,0,0,0,2,0,0,0,2,0,2,0,0,2,0,0,0,2,0,0,0,2,0,0,0,2,0,2,1
1,2,0,2,0,2,2,2,2,2,0,2,0,2,0,2,2,2,2,0,2,0,2,2,2,2,2,0,2,0,2,1
1,2,0,2,0,2,0,0,0,2,0,2,0,2,0,2,0,0,2,0,2,0,2,0,0,0,2,0,2,0,2,1
1,2,0,2,0,2,2,3,2,2,0,2,0,2,0,2,2,2,2,0,2,0,2,2,3,2,2,0,2,0,2,1
1,2,0,2,0,2,0,0,0,2,0,2,0,2,0,2,0,0,2,0,2,0,2,0,0,0,2,0,2,0,2,1
1,2,0,2,0,2,2,2,2,2,0,2,0,2,0,2,2,2,2,0,2,0,-1,2,2,2,2,0,2,0,2,1
1,2,0,2,0,0,0,2,0,0,0,2,0,2,0,0,0,2,0,0,2,0,0,0,2,0,0,0,2,0,2,1
1,2,0,2,2,2,2,2,2,2,2,2,2,2,2,2,2,2,2,2,2,2,2,2,2,2,2,2,2,0,2,1
1,2,0,0,0,0,0,0,0,0,0,0,0,0,0,0,0,0,0,0,0,0,0,0,0,0,0,0,0,0,2,1
1,2,2,2,2,2,2,2,2,2,2,2,1,2,2,2,2,2,2,1,2,2,2,2,2,2,2,2,2,2,2,1
-1,-1,1,1,1,1,3,1,1,1,1,2,2,2,1,1,1,1,2,2,2,1,1,1,1,3,1,1,1,1,-1,-1
1,2,2,2,2,2,2,2,2,2,2,2,1,-1,2,2,2,2,2,1,2,2,2,2,2,2,2,2,2,2,2,1
1,1,1,1,1,1,1,1,1,1,1,1,1,1,1,1,1,1,1,1,1,1,1,1,1,1,1,1,1,1,1,1
1,21
30,21
13,22
15,3
17,3
14,3
3,2,375
13,7,22,16
1002,940,880,450,400,300,225,175,150,125,100,50
2
11,22,2,13,19,0
20,22,2,18,19,0