1,1,1,1,1,1,1,1,1,1,1,1,1,1,1,1,1,1,1,1,1,1,1,1,1,1,1,1,1,1,1,1
1,2,2,2,2,2,2,2,2,2,2,2,2,2,2,2,2,2,2,2,2,2,2,2,2,2,2,2,2,2,2,1
1,2,0,0,0,0,2,0,0,0,0,6,0,0,0,0,0,2,0,0,0,0,0,2,0,2,0,0,0,0,2,1
1,2,2,2,2,0,2,0,0,0,2,2,0,0,0,0,0,2,6,-1,-1,6,6,2,0,2,2,2,0,0,2,1
1,2,0,0,3,0,2,0,0,0,2,0,2,2,2,2,6,2,0,0,-1,0,0,2,0,2,0,2,3,6,2,1
1,2,2,0,6,0,2,0,0,0,2,0,2,0,0,0,0,2,0,0,-1,0,0,2,0,2,0,2,0,0,2,1
1,1,-1,2,2,2,2,0,0,0,2,0,2,2,2,2,6,2,0,0,6,0,2,2,2,6,2,2,2,6,2,1
1,1,-1,0,0,0,0,0,0,0,2,0,0,0,0,0,0,2,2,2,2,2,2,0,2,0,0,0,0,0,2,1
1,2,2,2,2,2,2,2,2,2,2,2,2,2,2,2,6,2,0,0,0,0,6,0,2,0,2,2,2,2,2,1
1,2,0,0,0,2,0,0,0,0,2,0,0,0,0,0,0,2,6,2,2,2,-1,0,2,0,2,0,0,0,2,1
1,2,0,0,0,2,0,0,0,0,2,6,2,2,2,2,2,2,0,0,0,0,0,0,2,6,2,0,0,0,6,1
1,2,0,0,0,2,0,0,0,0,2,0,0,0,0,0,0,2,0,2,2,2,6,2,2,0,2,2,6,6,2,-1
1,2,2,2,2,2,0,0,0,0,2,0,0,0,0,0,0,2,0,2,0,0,0,0,0,0,2,0,0,0,6,1
1,2,0,6,0,2,6,2,2,2,2,2,2,2,2,2,6,2,0,6,0,2,2,2,2,2,2,2,0,0,2,1
1,2,0,2,0,2,0,0,0,0,0,0,0,2,0,0,0,0,0,2,0,2,0,0,0,0,0,6,0,0,2,1
1,2,0,2,0,2,2,2,2,0,0,0,0,2,0,2,2,2,2,2,0,2,0,0,2,6,2,2,0,0,2,1
1,2,0,2,0,0,0,0,2,0,0,0,0,2,0,2,0,6,0,2,0,2,0,0,2,0,2,0,0,0,2,1
1,2,0,2,2,2,2,6,2,0,0,0,0,2,0,2,0,-1,0,2,0,2,0,0,2,0,2,6,2,6,2,1
1,2,0,2,0,0,0,0,6,0,0,0,0,6,0,2,0,2,0,2,0,2,6,2,2,0,2,0,0,0,2,1
1,2,0,2,0,2,2,2,2,2,2,2,0,2,0,6,0,2,0,2,0,2,0,0,0,0,6,0,0,0,2,1
1,2,0,3,0,2,0,0,0,0,0,2,0,2,2,2,2,2,6,2,0,2,0,2,2,2,3,6,2,6,2,1
1,2,0,6,0,6,0,0,0,0,0,2,0,6,0,0,0,0,0,0,0,6,0,2,0,0,0,0,0,0,2,1
1,2,2,2,2,2,2,2,2,2,2,2,2,2,2,2,2,2,2,2,2,2,2,2,2,2,2,2,2,2,2,1
1,1,1,1,1,1,1,1,1,1,1,1,1,1,1,1,1,1,1,1,1,1,1,1,1,1,1,1,1,1,1,1
2,7
2,6
20,4
20,5
20,3
19,3
3,2,400
22,9,17,17
1002,900,800,400,300,200,150,125,100,50,40,25
0