1,1,1,1,1,1,1,1,1,1,1,1,1,1,1,1,1,1,1,1,1,1,1,1,1,1,1,1,1,1,1,1
1,2,2,2,2,2,2,2,2,2,2,2,2,2,2,2,2,2,2,2,1,1,1,1,2,2,2,2,2,2,2,1
1,2,0,6,0,2,0,6,0,2,0,6,0,2,1,1,1,1,1,2,2,2,2,2,2,1,1,2,1,1,2,1
1,2,0,2,0,2,0,2,0,2,0,2,0,2,2,2,2,2,1,2,1,1,2,1,2,2,2,2,1,-1,2,1
1,2,0,2,0,6,0,2,0,6,0,2,0,2,1,1,1,2,2,2,2,2,2,1,2,2,1,1,1,-1,2,1
1,2,0,2,2,2,2,2,2,2,2,2,0,2,2,2,1,1,1,2,1,1,2,3,2,1,1,1,1,1,2,1
1,2,0,3,0,0,0,0,0,0,0,2,0,2,1,2,2,2,2,2,2,2,2,1,2,2,2,2,2,2,2,1
1,2,0,2,2,2,2,2,2,2,2,2,0,2,1,1,1,1,2,1,1,1,1,1,2,1,1,1,2,1,2,1
1,2,0,0,0,-1,0,0,0,2,0,0,0,2,2,2,2,2,2,2,2,2,2,2,2,2,2,2,2,2,2,1
1,2,0,2,2,2,2,2,2,2,2,2,0,2,0,6,0,2,0,6,0,2,0,6,0,2,0,6,0,2,1,1
1,2,0,2,0,0,0,0,0,0,0,2,0,2,0,-1,0,2,0,-1,0,2,0,-1,0,2,0,-1,0,2,1,1
1,2,0,2,2,2,2,2,2,2,2,2,0,6,0,2,0,6,0,2,0,6,0,2,0,6,0,2,0,2,1,1
1,2,0,0,0,0,2,2,2,2,0,2,2,2,2,2,2,2,2,2,2,2,2,2,2,2,2,2,0,2,1,1
1,2,0,2,2,2,2,1,1,2,2,0,2,0,0,2,0,0,2,0,0,2,0,0,2,0,0,2,0,2,1,1
1,2,0,2,2,2,1,2,6,1,2,2,2,0,2,2,2,0,2,0,0,2,0,2,2,2,0,2,0,2,1,1
1,2,0,2,2,1,2,2,6,2,1,2,2,0,2,0,2,0,2,0,0,2,0,2,0,2,0,2,0,2,1,1
1,2,0,2,3,1,2,2,6,2,1,2,2,0,2,2,2,0,2,0,0,2,0,2,2,2,0,2,0,2,1,1
1,2,0,2,1,2,2,2,6,2,2,1,2,0,0,2,0,0,2,0,0,-1,0,0,2,0,0,2,0,2,1,1
1,2,0,2,1,2,6,6,6,2,2,1,2,2,2,2,2,2,2,2,2,2,2,2,2,2,2,2,0,2,1,1
1,2,0,2,1,2,2,2,6,2,2,1,2,0,0,2,0,0,0,0,0,0,0,0,3,0,0,2,0,2,1,1
1,2,0,2,1,2,2,2,6,2,2,1,2,2,2,2,2,2,2,2,2,2,2,2,2,2,2,2,0,2,1,1
1,2,0,6,1,1,1,1,1,1,1,1,0,0,0,0,0,0,0,0,0,0,0,0,0,0,0,0,0,2,1,1
1,2,2,2,2,2,2,2,2,2,2,2,2,2,2,2,2,2,2,2,2,2,2,2,2,2,2,2,2,2,1,1
1,1,1,1,1,1,1,1,1,1,1,1,1,1,1,1,1,1,1,1,1,1,1,1,1,1,1,1,1,1,1,1
29,3
29,4
23,10
27,10
19,10
15,10
3,2,345
5,8,21,17
1002,920,840,350,300,225,175,150,140,110,100,75
1
16,16,2,11,20,0