1,1,1,1,1,1,1,1,1,1,1,1,1,1,1,1,1,1,1,1,1,1,1,1,1,1,1,1,1,1,1,1
1,4,4,4,2,2,2,2,2,2,2,2,2,2,2,2,2,2,2,2,2,2,2,2,2,2,2,2,2,4,1,1
-1,2,2,2,2,2,2,2,-1,2,2,2,4,4,4,4,4,4,4,4,4,3,2,2,2,2,2,2,2,2,2,-1
1,4,4,2,2,2,3,2,2,2,2,4,4,1,1,1,1,1,1,1,4,4,2,2,3,2,2,2,3,4,1,1
1,4,2,2,2,2,2,2,2,2,2,2,0,2,2,2,2,2,2,1,1,4,2,2,2,2,2,2,4,4,1,1
1,4,2,2,2,2,2,2,2,2,4,1,1,2,2,0,0,0,2,2,1,4,2,2,2,2,2,4,4,1,1,1
1,1,4,4,3,2,2,2,4,4,1,1,2,2,0,0,0,0,0,2,1,4,2,2,2,2,4,1,1,5,2,1
1,1,1,4,4,4,4,4,4,1,1,2,2,0,0,0,0,0,0,2,1,4,4,2,2,2,4,1,2,2,2,1
1,2,2,1,1,1,1,1,1,1,2,2,2,2,2,2,2,2,2,2,2,1,4,4,5,2,4,1,2,0,2,1
1,2,2,2,2,2,2,2,0,2,2,2,0,2,0,0,0,0,0,0,2,1,1,4,4,4,4,1,2,2,2,1
1,1,2,0,2,0,2,2,0,2,0,2,0,2,2,2,2,2,0,0,2,1,1,1,1,1,1,1,2,2,1,1
-1,2,2,0,3,0,2,2,0,2,0,2,2,0,0,0,0,2,2,2,2,0,2,2,2,2,2,2,2,2,2,-1
1,1,2,0,2,0,2,4,0,4,4,4,2,0,-1,2,2,2,4,4,4,0,4,2,0,2,0,2,2,2,1,1
1,2,2,0,2,0,2,2,0,2,2,4,2,0,2,2,0,2,4,2,2,0,2,2,0,2,0,2,1,1,1,1
1,2,2,2,2,0,2,4,0,4,2,4,2,2,2,-1,0,2,4,2,4,0,4,2,0,3,0,2,1,4,4,1
1,1,1,2,2,0,2,2,0,2,2,2,2,0,0,0,0,2,2,2,0,0,2,2,0,2,2,2,1,4,5,1
1,4,1,1,2,2,2,2,0,2,0,0,0,0,0,0,2,2,0,0,0,0,2,2,0,2,2,1,4,4,2,1
1,2,4,1,1,-1,-1,-1,0,2,2,2,2,0,0,0,2,1,1,1,1,1,2,2,2,2,1,4,4,2,2,1
1,2,4,4,1,1,5,-1,1,1,1,1,2,2,2,2,2,1,4,4,4,1,1,2,2,1,4,4,3,2,2,1
1,2,2,4,4,1,1,1,1,4,4,1,1,1,2,2,0,2,2,2,2,4,1,1,1,4,4,2,2,2,0,1
1,0,2,2,4,4,1,4,4,4,4,4,4,1,1,1,4,4,2,2,2,4,4,4,4,4,2,2,2,0,0,1
-1,2,2,2,2,4,4,4,3,2,2,2,2,4,4,4,3,2,2,2,2,2,-1,2,2,2,2,2,2,2,2,-1
1,0,0,2,2,2,2,3,2,2,2,2,2,2,2,2,2,2,2,2,2,2,2,2,3,2,2,0,0,0,0,1
1,1,1,1,1,1,1,1,1,1,1,1,1,1,1,1,1,1,1,1,1,1,1,1,1,1,1,1,1,1,1,1
14,12
15,14
7,17
7,18
6,17
5,17
3,2,350
8,2,22,21
1002,900,850,450,400,300,225,175,150,100,50,25
4
12,4,1,0,0,75
8,13,1,0,0,150
21,13,1,0,0,225
16,19,1,0,0,300