1,1,1,1,1,1,1,1,1,1,1,1,1,1,1,1,1,1,1,1,1,1,1,1,1,1,1,1,1,1,1,1
1,2,2,2,2,2,2,2,2,2,2,2,2,2,2,2,2,2,2,2,2,2,2,2,2,2,2,2,2,2,2,1
1,3,0,0,0,2,0,2,0,2,0,0,0,2,0,2,0,0,0,2,0,2,0,0,2,0,2,0,0,0,3,1
1,2,0,2,2,2,0,2,0,2,2,2,0,2,0,2,2,2,0,2,0,2,2,2,2,0,2,2,2,0,2,1
1,2,0,2,0,0,0,2,0,0,0,2,0,2,0,0,0,2,0,2,0,0,0,0,2,0,0,0,2,0,2,1
1,2,2,2,2,2,2,2,2,2,2,2,2,2,2,2,2,2,2,2,2,2,2,2,2,2,0,2,2,2,2,1
1,2,0,0,0,0,0,2,0,0,0,0,0,2,0,0,0,0,0,0,0,2,0,0,0,2,2,2,0,2,2,1
1,2,0,2,2,2,0,2,0,2,2,2,2,2,2,2,-1,2,2,2,2,2,2,2,0,2,0,0,0,0,2,1
1,2,2,2,0,2,2,2,0,2,0,0,2,0,0,2,0,2,0,0,2,0,0,2,0,2,2,2,2,2,2,1
1,2,0,0,0,0,0,2,2,2,2,2,2,2,2,2,0,2,2,2,2,2,2,2,2,2,0,2,2,0,2,1
1,2,2,2,2,2,2,2,0,2,0,0,0,0,0,2,0,2,0,0,0,0,0,2,0,2,0,-1,-1,0,2,1
1,2,0,0,0,0,0,2,0,2,0,2,2,2,0,2,2,2,2,2,0,2,2,2,0,2,0,0,0,0,2,1
1,2,0,-1,-1,0,2,2,0,2,2,2,0,2,2,2,-1,2,0,2,2,2,0,2,0,2,2,2,2,2,2,1
1,2,0,2,2,0,2,0,0,2,0,0,0,0,0,2,0,2,0,0,0,0,0,2,0,2,0,0,0,0,2,1
1,2,2,2,2,2,2,2,2,2,2,2,2,2,2,2,0,2,2,2,2,2,2,2,2,2,2,0,0,2,2,1
1,2,0,0,0,0,0,2,0,2,0,0,2,0,0,2,0,2,0,0,2,0,0,2,0,0,2,2,2,2,0,1
1,2,2,2,2,2,2,2,0,2,2,2,2,2,2,2,-1,2,2,2,2,2,2,2,0,2,2,0,0,2,2,1
1,2,0,0,0,0,0,2,0,0,0,0,0,2,0,0,0,0,0,0,0,2,0,0,0,2,0,0,0,0,2,1
1,2,2,2,2,2,2,2,2,2,2,2,2,2,2,2,2,2,2,2,2,2,2,2,2,2,2,2,2,2,2,1
1,2,0,2,0,0,0,2,0,0,0,0,2,0,2,0,0,0,2,0,2,0,0,0,2,0,0,0,2,0,2,1
1,2,0,2,2,2,0,2,2,2,2,0,2,0,2,2,2,0,2,0,2,2,2,0,2,0,2,2,2,0,2,1
1,3,0,0,0,2,0,2,0,0,2,0,2,0,0,0,2,0,2,0,0,0,2,0,2,0,2,0,0,0,3,1
1,2,2,2,2,2,2,2,2,2,2,2,2,2,2,2,2,2,2,2,2,2,2,2,2,2,2,2,2,2,2,1
1,1,1,1,1,1,1,1,1,1,1,1,1,1,1,1,1,1,1,1,1,1,1,1,1,1,1,1,1,1,1,1
16,7
16,16
27,10
28,10
4,12
3,12
3,2,470
16,12,16,12
1002,875,750,375,325,225,165,135,105,60,50,25
0