1,1,1,1,1,1,1,1,1,1,1,1,1,1,1,1,1,1,1,1,1,1,1,1,1,1,1,1,1,1,1,1
1,2,2,2,2,2,2,2,2,2,2,2,2,2,2,2,2,2,2,2,2,2,2,2,2,2,2,2,2,2,2,1
1,2,0,0,0,0,0,0,0,0,0,0,0,0,0,0,0,0,0,0,0,2,0,2,0,0,0,0,0,0,2,1
1,-1,2,2,2,2,2,2,0,2,2,2,0,2,2,2,2,2,2,2,0,2,0,2,0,2,2,2,2,0,2,1
1,2,0,0,0,0,0,2,0,2,0,2,0,2,0,0,0,0,0,2,0,2,0,2,0,2,0,0,2,0,2,1
1,-1,2,2,2,2,0,2,0,2,0,2,0,2,0,2,2,2,0,2,0,2,0,2,0,2,0,0,2,0,2,1
1,2,0,0,0,2,0,2,2,2,0,2,2,2,0,2,0,2,0,2,0,2,2,2,0,2,0,0,2,0,2,1
1,2,2,2,0,2,0,0,0,0,0,0,0,0,0,2,0,2,0,2,0,0,0,0,0,2,0,0,2,0,-1,1
1,2,0,2,0,2,2,0,2,2,2,2,2,2,0,2,0,2,0,2,2,2,3,2,2,2,0,0,2,0,5,1
1,2,0,2,0,0,2,0,2,0,2,0,0,2,0,2,0,2,0,0,0,0,0,0,0,0,0,0,2,0,4,1
1,2,0,2,0,0,2,0,2,0,2,2,2,2,0,2,0,3,2,2,2,2,2,0,2,2,2,0,2,0,0,1
-1,2,2,2,2,0,2,0,2,0,2,0,0,0,0,2,0,0,0,0,0,0,2,0,2,0,2,0,2,2,2,-1
1,2,0,0,2,0,2,0,2,0,2,2,2,2,0,-1,2,2,2,-1,-1,0,2,0,2,0,2,0,2,0,0,1
1,2,0,0,2,0,2,0,2,0,2,0,0,-1,0,0,2,2,2,-1,-1,0,2,0,2,0,2,2,2,0,4,1
1,2,0,0,2,0,2,0,2,0,2,2,2,2,0,0,2,0,0,0,0,0,2,0,2,0,0,0,0,0,5,1
1,2,0,0,2,0,2,0,2,0,2,0,0,0,0,0,2,0,2,2,2,2,2,0,2,2,2,2,2,0,2,1
1,2,0,0,2,0,2,0,2,0,2,0,2,2,2,2,2,0,2,0,0,0,0,0,0,0,0,0,2,0,2,1
1,2,0,0,2,0,2,0,2,0,3,0,2,0,0,0,2,0,2,0,2,2,2,2,2,2,2,0,2,0,2,1
1,2,0,0,2,0,2,0,2,0,2,0,2,2,2,2,2,0,2,0,2,0,0,0,0,0,2,0,2,0,2,1
1,2,0,0,2,0,2,0,2,0,2,0,0,0,0,0,2,0,2,0,2,0,2,2,2,0,2,0,2,0,2,1
1,2,0,0,2,0,2,2,2,0,2,2,2,2,2,2,2,0,2,2,2,0,2,0,2,0,2,2,2,0,2,1
1,2,0,0,2,0,0,0,0,0,0,0,0,0,0,0,0,0,0,0,0,0,2,0,2,0,0,0,0,0,2,1
1,2,2,2,2,2,2,2,2,2,2,2,2,2,2,2,2,2,2,2,2,2,2,3,2,2,2,2,2,2,2,1
1,1,1,1,1,1,1,1,1,1,1,1,1,1,1,1,1,1,1,1,1,1,1,1,1,1,1,1,1,1,1,1
1,3
1,5
19,13
19,12
20,13
20,12
3,2,420
13,13,15,12
1002,930,860,500,450,350,275,225,200,110,100,50
2
18,13,2,14,6,0
20,20,2,21,9,0