1,1,1,1,1,1,1,1,1,1,1,1,1,1,1,1,1,1,1,1,1,1,1,1,1,1,1,1,1,1,1,1
-1,-1,-1,2,2,2,2,2,2,2,2,2,2,2,2,2,2,2,2,2,2,2,2,2,2,2,2,2,2,2,-1,-1
1,0,0,0,0,0,0,0,0,0,0,0,0,0,0,0,0,0,0,0,0,0,0,0,0,0,0,0,0,0,0,1
1,2,2,2,2,2,2,2,2,2,2,2,2,2,0,0,2,2,2,2,2,2,2,2,2,2,2,2,2,2,2,1
1,2,0,0,0,2,0,6,6,0,2,2,0,2,2,2,2,0,2,2,0,6,6,0,2,0,2,0,0,0,2,1
1,2,2,2,0,2,3,0,6,6,0,2,2,0,2,2,0,2,2,0,6,6,0,3,2,0,2,0,2,2,2,1
1,2,0,2,0,2,2,2,0,6,6,0,2,2,0,0,2,2,0,6,6,0,2,2,2,0,2,0,2,0,2,1
1,2,0,2,0,2,0,2,2,0,6,6,0,2,2,2,2,0,6,6,0,2,2,2,2,2,2,0,2,0,2,1
1,2,0,2,2,2,0,0,2,2,0,6,6,0,2,2,0,6,6,0,2,2,2,0,2,0,2,2,2,0,2,1
1,2,0,2,0,2,2,2,0,2,2,0,6,6,0,0,6,6,0,2,2,2,0,2,2,0,2,0,2,0,2,1
1,2,2,2,0,2,0,2,2,2,2,2,0,6,6,6,6,0,2,2,2,0,0,2,0,0,2,0,2,2,2,1
1,2,0,2,0,2,0,0,2,2,0,-1,0,6,-1,-1,6,0,-1,-1,2,2,0,2,0,0,2,0,2,0,2,1
1,2,0,2,2,2,0,2,2,0,2,2,0,6,6,6,6,0,2,2,0,2,2,2,2,2,2,2,2,0,2,1
1,2,0,2,0,2,2,2,2,2,2,0,6,6,0,0,6,6,0,2,2,0,2,0,0,0,2,0,2,0,2,1
1,2,0,2,0,2,0,0,2,2,0,6,6,0,2,2,0,6,6,0,2,2,2,2,2,0,2,0,2,0,2,1
1,2,2,2,0,2,0,2,2,0,6,6,0,2,2,2,2,0,6,6,0,2,2,0,2,2,2,0,2,2,2,1
1,2,0,2,0,2,2,2,0,6,6,0,2,2,0,0,2,2,0,6,6,0,2,2,0,2,2,0,2,0,2,1
1,2,0,2,2,2,2,0,6,6,0,2,2,0,0,0,0,2,2,0,6,6,0,2,2,0,2,2,2,0,2,1
1,2,0,2,0,2,0,6,6,0,2,2,2,0,2,2,2,2,2,2,0,6,6,0,2,2,2,0,2,0,2,1
1,2,0,2,0,2,6,6,0,2,2,0,2,0,2,0,0,2,0,2,2,0,6,6,0,2,2,0,2,0,2,1
1,2,2,2,0,2,6,0,2,2,0,0,2,0,2,0,0,2,0,0,2,2,0,6,6,0,2,0,2,2,2,1
1,2,0,0,0,2,0,3,2,0,0,0,2,0,2,0,0,2,0,0,0,2,3,0,6,0,2,0,0,0,2,1
1,2,2,2,2,2,2,2,2,2,2,2,2,2,2,2,2,2,2,2,2,2,2,2,2,2,2,2,2,2,2,1
1,1,1,1,1,1,1,1,1,1,1,1,1,1,1,1,1,1,1,1,1,1,1,1,1,1,1,1,1,1,1,1
1,1
2,1
15,11
18,11
14,11
30,1
3,2,330
11,11,19,11
1002,925,850,410,375,275,200,150,125,60,50,10
2
13,1,2,26,2,0
5,14,2,13,2,0