1,1,1,1,1,1,1,1,1,1,1,1,1,1,1,1,1,1,1,1,1,1,1,1,1,1,1,1,1,1,1,1
1,2,2,2,2,2,2,2,2,2,2,2,2,2,2,2,2,2,1,1,2,2,2,2,2,2,2,2,2,2,2,1
1,2,0,2,0,6,0,6,0,2,0,0,0,6,0,2,0,6,6,2,2,0,6,0,2,0,6,0,0,0,2,1
1,2,0,2,3,2,0,2,0,2,0,2,2,2,0,2,0,2,0,2,0,0,2,0,2,0,2,3,2,2,2,1
1,2,0,0,0,0,0,2,0,2,0,6,0,0,0,2,0,-1,0,2,2,2,2,0,6,0,0,0,0,0,2,1
1,2,6,2,2,2,2,2,0,2,2,2,0,2,6,2,0,-1,0,2,0,0,0,0,2,6,2,0,2,6,2,1
1,2,0,0,0,6,0,0,0,6,0,6,0,2,0,2,0,-1,0,2,0,2,2,2,2,0,2,2,2,0,2,1
1,2,0,2,2,2,2,6,2,2,0,2,6,2,0,2,0,-1,0,2,6,2,0,0,0,0,0,6,0,0,2,1
1,2,0,2,0,0,0,0,0,0,0,2,0,0,0,2,0,2,0,2,0,2,6,2,2,2,0,2,2,6,2,1
1,2,0,2,2,6,2,2,2,2,2,2,2,2,2,2,6,6,0,2,0,0,0,0,0,2,0,0,2,0,2,1
1,2,0,0,6,0,0,0,0,0,6,0,0,0,0,0,2,0,0,2,6,2,2,2,0,2,2,-1,2,0,2,1
1,2,6,2,2,2,2,6,2,2,2,2,0,0,6,6,2,0,0,6,0,0,0,2,0,2,0,0,0,0,2,1
1,2,0,0,2,0,6,0,0,0,0,2,0,0,2,0,2,6,2,2,2,2,2,2,0,2,2,2,2,6,2,1
1,2,0,0,2,0,2,2,2,2,0,-1,2,2,2,0,2,0,0,0,0,6,0,2,6,2,0,6,0,0,2,1
1,2,0,0,6,0,0,0,0,6,0,0,0,6,0,0,2,6,2,2,2,2,0,2,0,2,0,2,2,0,2,1
1,2,2,2,2,2,2,6,2,2,2,2,2,2,6,2,2,0,2,0,0,0,0,2,0,2,0,0,2,0,2,1
1,2,0,6,0,0,0,0,2,0,0,0,6,0,0,0,6,0,2,0,2,6,2,2,0,2,2,2,2,6,2,1
1,2,0,2,2,2,2,2,2,2,2,0,2,6,2,2,2,0,2,0,2,0,0,6,0,6,0,0,0,0,2,1
1,2,0,0,0,0,2,0,0,0,2,0,2,0,2,0,2,0,2,6,2,0,2,2,2,2,2,2,2,6,2,1
1,2,6,2,0,0,2,6,2,0,2,6,2,0,6,0,2,0,2,0,2,0,2,0,0,0,6,0,0,0,2,1
1,2,0,2,3,2,2,0,2,2,2,0,2,0,-1,0,2,6,2,0,2,0,2,0,2,2,2,3,2,0,2,1
1,2,0,0,0,2,0,0,0,6,0,0,6,0,-1,0,6,0,0,0,6,0,6,0,2,0,0,0,2,0,2,1
1,2,2,2,2,2,2,2,2,2,2,2,2,2,2,2,2,2,2,2,2,2,2,2,2,2,2,2,2,2,2,1
1,1,1,1,1,1,1,1,1,1,1,1,1,1,1,1,1,1,1,1,1,1,1,1,1,1,1,1,1,1,1,1
14,21
14,20
17,6
17,7
17,5
17,4
3,2,400
11,13,27,10
1002,940,870,410,370,270,195,145,120,85,75,50
0