1,1,1,1,1,1,1,1,1,1,1,1,1,1,1,1,1,1,1,1,1,1,1,1,1,1,1,1,1,1,1,1
1,2,2,2,2,2,2,2,2,2,2,2,2,2,2,2,2,2,2,2,2,2,2,2,2,2,2,2,2,2,2,1
1,2,0,0,6,0,0,2,0,2,0,0,6,0,0,2,0,2,0,0,6,0,0,2,0,2,0,6,6,0,2,1
1,2,0,2,3,2,0,2,2,2,0,2,2,2,0,2,2,2,0,2,2,2,0,2,2,2,0,2,2,0,2,1
1,2,0,2,0,2,0,0,6,0,0,2,0,2,0,0,6,0,0,2,0,2,0,0,6,0,0,-1,2,0,2,1
1,2,0,2,0,2,2,2,2,2,2,2,0,2,2,2,2,2,2,2,0,2,2,2,2,2,2,2,2,0,2,1
1,2,0,2,0,2,0,0,6,0,0,2,0,2,0,0,6,0,0,2,0,2,0,0,6,0,0,-1,2,0,2,1
-1,2,0,2,0,2,0,2,2,2,0,2,0,2,0,2,2,2,0,2,0,2,0,2,2,2,0,2,2,0,2,-1
1,2,0,2,2,2,0,2,0,2,0,2,2,2,0,2,0,2,0,2,2,2,0,2,0,2,0,2,2,0,2,1
1,2,0,0,6,0,0,2,0,2,0,0,6,0,0,2,0,2,0,0,6,0,0,2,0,2,0,6,6,0,2,1
1,2,3,2,2,2,2,2,0,2,2,2,-1,2,2,2,0,2,2,2,-1,2,2,2,0,2,2,2,2,3,2,1
1,2,0,0,6,0,0,2,0,2,0,0,6,0,0,2,0,2,0,0,6,0,0,2,0,2,0,6,6,0,2,1
1,2,0,2,2,2,0,2,0,2,0,2,2,2,0,2,0,2,0,2,2,2,0,2,0,2,0,-1,-1,0,2,1
1,2,0,2,0,2,0,2,0,2,0,2,0,2,0,2,0,2,0,2,0,2,0,2,0,2,0,2,2,0,2,1
1,2,0,2,0,2,0,2,2,2,0,2,0,2,0,2,2,2,0,2,0,2,0,2,2,2,0,2,2,0,2,1
1,2,0,2,0,2,0,0,6,0,0,2,0,2,0,0,6,0,0,2,0,2,0,0,6,0,0,2,2,0,2,1
1,2,0,2,0,2,2,2,2,2,2,2,0,2,2,2,2,2,2,2,0,2,2,2,2,2,2,2,2,0,2,1
-1,2,0,2,0,2,0,0,6,0,0,2,0,2,0,0,6,0,0,2,0,2,0,0,6,0,0,2,2,0,2,-1
1,2,0,2,0,2,0,2,2,2,0,2,0,2,0,2,2,2,0,2,0,2,0,2,2,2,0,2,2,0,2,1
1,2,0,2,0,2,0,2,0,2,0,2,0,2,0,2,0,2,0,2,0,2,0,2,0,2,0,2,2,0,2,1
1,2,0,2,3,2,0,2,0,2,0,2,2,2,0,2,0,2,0,2,2,2,0,2,0,2,0,-1,-1,0,2,1
1,2,0,0,6,0,0,2,0,2,0,0,6,0,0,2,0,2,0,0,6,0,0,2,0,2,0,6,6,0,2,1
1,2,2,2,2,2,2,2,2,2,2,2,2,2,2,2,2,2,2,2,2,2,2,2,2,2,2,2,2,2,2,1
1,1,1,1,1,1,1,1,1,1,1,1,1,1,1,1,1,1,1,1,1,1,1,1,1,1,1,1,1,1,1,1
27,6
27,4
27,12
28,12
27,20
28,20
3,2,385
12,10,20,10
1002,920,840,410,370,270,195,145,120,85,75,50
0