1,1,1,1,1,1,1,1,1,1,1,1,1,1,1,1,1,1,1,1,1,1,1,1,1,1,1,1,1,1,1,1
1,3,2,2,2,2,2,2,2,2,2,2,2,2,2,2,2,2,2,2,2,2,2,2,2,2,2,2,2,2,3,1
1,2,1,1,1,1,1,2,1,1,1,2,1,1,1,1,2,1,1,1,2,1,1,2,1,1,1,1,2,1,2,1
1,2,1,1,1,1,1,2,1,1,1,2,1,1,1,1,2,1,1,1,2,-1,-1,2,1,1,1,1,2,1,2,1
1,2,1,1,1,1,1,2,1,1,1,2,2,2,2,2,2,1,1,1,2,1,1,2,1,2,2,2,2,2,2,1
1,2,1,1,1,1,1,2,1,1,1,2,1,1,1,1,2,1,1,1,2,1,1,2,1,2,1,1,1,1,2,1
1,2,2,2,2,2,2,2,2,2,2,2,2,2,2,2,2,1,1,1,2,2,2,2,2,2,1,1,1,1,2,1
1,2,1,2,1,1,1,1,1,2,1,1,1,1,1,1,2,1,1,1,2,1,1,1,1,2,1,1,1,1,2,1
1,2,1,2,1,1,1,1,1,2,1,1,1,1,1,1,2,1,1,1,2,1,1,1,1,2,2,2,-1,2,2,1
1,2,1,2,2,2,2,2,2,2,1,1,1,1,1,1,2,2,2,2,2,1,1,1,1,2,1,1,1,1,2,1
1,2,1,2,1,1,1,1,1,2,1,1,-1,-1,1,1,2,1,1,2,1,1,1,1,1,2,2,1,1,1,2,1
1,2,1,2,1,1,1,1,1,2,1,1,-1,-1,1,1,2,1,1,2,1,1,1,1,1,1,2,1,1,1,2,1
1,2,1,2,1,1,1,1,1,2,2,2,2,2,2,2,2,1,1,2,2,2,2,2,1,1,2,2,2,2,2,1
1,2,2,2,1,1,1,1,1,2,1,1,1,2,1,1,1,1,1,2,1,1,1,2,1,1,2,1,1,1,2,1
1,2,1,2,2,-1,2,2,2,2,1,1,1,2,2,2,2,2,2,2,2,1,1,2,2,2,2,1,1,1,2,1
1,2,1,1,1,1,1,1,2,1,1,1,1,2,1,1,1,2,1,1,2,1,1,1,1,1,2,1,1,1,2,1
1,2,1,1,1,1,1,1,2,1,1,1,1,2,2,2,2,2,1,1,2,1,1,1,1,1,2,2,2,2,2,1
1,2,1,1,1,1,1,1,2,1,1,1,1,2,1,1,1,2,1,1,2,1,1,1,1,1,2,1,2,1,2,1
1,2,2,2,2,1,2,2,2,2,2,2,2,2,2,1,1,2,2,2,2,2,2,2,2,2,2,1,2,1,2,1
1,2,1,1,2,1,2,1,1,1,1,1,1,1,2,1,1,1,2,1,1,1,1,1,2,1,1,1,2,1,2,1
1,2,1,1,2,1,2,1,1,1,1,1,1,1,2,1,1,1,2,1,1,1,1,1,2,1,1,1,2,1,2,1
1,2,1,1,2,1,2,1,1,1,1,1,1,1,2,1,1,1,2,1,1,1,1,1,2,1,1,1,2,1,2,1
1,3,2,2,2,2,2,2,2,2,2,2,2,2,2,2,2,2,2,2,2,2,2,2,2,2,2,2,2,2,3,1
1,1,1,1,1,1,1,1,1,1,1,1,1,1,1,1,1,1,1,1,1,1,1,1,1,1,1,1,1,1,1,1
21,3
22,3
13,11
12,11
13,10
12,10
3,2,300
5,14,28,8
1002,915,830,315,275,275,200,150,125,75,50,25
0