1,1,1,1,1,1,1,1,1,1,1,1,1,1,1,1,1,1,1,1,1,1,1,1,1,1,1,1,1,1,1,1
-1,-1,2,2,2,2,2,2,2,2,2,2,2,2,2,2,2,2,2,2,2,2,2,2,2,2,2,2,2,2,-1,-1
1,1,1,1,1,1,1,1,1,1,1,1,1,1,1,1,1,1,1,1,1,1,1,1,1,1,1,1,1,1,1,1
1,2,2,2,2,2,2,2,2,2,2,2,2,2,2,2,2,2,2,2,2,2,2,2,2,2,2,2,2,2,2,1
1,2,0,0,0,0,0,0,0,2,0,2,0,0,0,2,0,2,0,2,0,0,0,2,0,2,0,0,0,0,2,1
1,2,0,2,2,3,2,2,0,2,0,2,2,2,2,2,0,2,0,2,2,2,2,2,0,2,2,2,3,2,2,1
1,2,2,2,0,0,0,2,2,2,0,2,0,0,0,2,0,2,0,2,0,0,0,2,0,2,0,0,0,0,2,1
1,2,0,2,2,2,2,2,0,2,0,2,2,2,2,2,0,2,0,2,2,2,2,2,0,2,2,2,2,2,2,1
1,2,0,0,0,0,0,0,0,2,0,0,0,2,0,0,0,2,0,0,0,0,0,0,0,2,0,0,0,0,2,1
1,2,0,2,2,2,2,2,0,2,0,2,2,2,2,2,0,2,0,2,2,2,2,2,0,2,0,0,2,2,2,1
1,2,0,2,0,0,0,2,0,2,0,2,0,0,0,2,0,2,2,2,0,0,0,2,2,2,0,0,2,0,2,1
1,2,0,2,2,2,2,2,0,2,0,2,2,2,2,2,0,2,0,2,2,2,2,2,0,2,0,-1,2,0,2,1
1,2,0,2,0,0,0,2,0,2,0,0,0,0,0,0,0,2,0,0,0,0,0,0,0,2,2,-1,2,0,2,1
1,2,0,2,2,2,2,2,0,2,0,2,2,2,2,2,0,2,0,2,2,2,2,2,0,2,-1,0,2,0,2,1
1,2,0,2,0,0,0,2,0,2,-1,2,0,0,0,2,2,2,0,2,0,0,0,2,0,2,0,0,2,2,2,1
1,2,0,2,2,2,2,2,0,2,0,2,2,2,2,2,0,2,0,2,2,2,2,2,0,2,0,0,0,0,2,1
1,2,0,0,0,2,0,0,0,2,0,0,0,0,0,0,0,2,0,2,0,0,0,2,0,2,2,2,2,2,2,1
1,2,0,2,2,2,2,2,0,2,0,2,3,2,2,2,0,2,0,2,2,2,2,2,0,2,0,0,0,0,2,1
1,2,0,2,0,0,0,2,0,2,0,2,0,0,0,2,0,2,0,2,0,0,0,2,0,2,2,2,3,2,2,1
1,2,0,2,0,0,0,2,0,2,0,2,0,0,0,2,0,2,0,2,0,0,0,2,0,2,0,0,0,0,2,1
1,2,2,2,2,2,2,2,2,2,2,2,2,2,2,2,2,2,2,2,2,2,2,2,2,2,2,2,2,2,2,1
1,1,1,1,1,1,1,1,1,1,1,1,1,1,1,1,1,1,1,1,1,1,1,1,1,1,1,1,1,1,1,1
-1,-1,2,2,2,2,2,2,2,2,2,2,2,2,2,2,2,2,2,2,2,2,2,2,2,2,2,2,2,2,-1,-1
1,1,1,1,1,1,1,1,1,1,1,1,1,1,1,1,1,1,1,1,1,1,1,1,1,1,1,1,1,1,1,1
1,22
30,1
27,11
27,12
30,22
1,1
3,2,400
10,14,26,13
1002,900,870,380,325,225,150,100,75,30,20,10
2
5,22,2,18,21,0
18,22,2,13,2,0