1,1,1,1,1,1,1,1,1,1,1,1,1,1,1,1,1,1,1,1,1,1,1,1,1,1,1,1,1,1,1,1
1,0,0,0,2,2,2,2,2,2,2,2,2,2,2,2,2,2,2,2,2,2,2,2,2,2,2,2,0,0,0,1
1,0,0,0,2,2,0,0,0,0,2,0,0,0,0,2,0,0,0,0,2,0,0,0,0,0,2,2,0,0,0,1
1,2,2,2,0,2,2,2,2,2,2,2,2,2,2,2,2,2,2,2,2,2,2,0,2,2,2,0,2,2,-1,1
1,2,0,2,0,0,0,0,2,0,0,2,0,0,2,0,0,0,0,2,0,0,2,2,2,0,0,2,2,0,2,1
1,2,0,2,2,2,2,0,2,2,2,2,0,2,2,2,2,2,0,2,0,2,2,0,0,2,2,2,2,0,2,1
1,2,0,2,0,2,2,2,0,0,0,2,0,2,0,0,0,2,0,2,2,2,0,0,2,2,2,0,2,2,2,1
1,2,0,2,0,2,0,2,0,0,0,2,2,2,2,2,0,2,2,2,0,0,2,2,2,0,2,0,2,0,2,1
1,2,2,2,0,2,2,2,2,2,0,0,0,2,2,5,2,2,0,0,2,2,2,0,2,0,2,0,2,0,2,1
1,2,0,2,0,2,0,0,0,2,2,2,2,0,2,4,2,0,2,2,2,0,2,2,2,0,2,2,2,0,2,1
1,2,0,2,2,2,2,2,2,2,0,0,2,2,0,0,0,-1,-1,0,2,0,0,0,0,0,2,0,2,0,2,1
-1,2,0,2,0,0,0,2,0,2,2,2,0,2,0,0,0,-1,0,0,2,0,2,2,2,2,2,0,2,2,2,-1
1,2,0,2,0,0,0,2,0,2,0,-1,2,2,0,0,0,-1,2,2,2,0,3,0,0,0,2,0,2,0,2,1
1,2,0,2,2,2,2,2,2,2,2,2,0,0,2,4,2,0,0,2,2,0,2,2,2,0,2,0,2,0,2,1
1,2,2,2,0,2,0,0,0,2,0,0,2,2,2,5,2,2,0,0,2,2,2,0,2,0,2,2,2,0,2,1
1,2,0,2,0,3,0,2,2,2,0,2,2,0,2,2,0,2,2,2,0,2,2,2,2,0,2,0,2,0,2,1
1,2,0,2,0,2,2,2,0,0,2,2,2,0,0,2,0,2,0,2,0,0,0,2,2,0,2,0,2,2,2,1
1,2,0,2,0,2,0,0,2,2,2,0,2,3,0,2,0,2,0,2,2,2,2,0,2,2,2,0,2,0,2,1
1,2,0,2,2,2,0,2,2,0,2,0,0,2,2,2,0,2,-1,2,0,0,2,2,0,0,2,2,2,0,2,1
1,2,2,2,0,0,2,2,0,2,2,2,0,2,0,0,0,2,0,0,0,0,0,2,2,2,0,2,2,2,2,1
1,2,2,0,0,2,2,0,0,2,0,2,2,2,2,2,2,2,2,2,2,2,2,2,0,2,2,0,0,2,-1,1
1,0,0,2,2,2,0,0,2,2,0,0,0,0,2,0,0,0,2,0,0,0,0,0,0,0,2,2,2,0,0,1
1,0,0,2,2,2,2,2,2,2,2,2,2,2,2,2,2,2,2,2,2,2,2,2,2,2,2,2,2,0,0,1
1,1,1,1,1,1,1,1,1,1,1,1,1,1,1,1,1,1,1,1,1,1,1,1,1,1,1,1,1,1,1,1
30,3
30,20
17,11
17,12
17,10
18,10
3,2,370
11,12,18,18
1002,920,840,400,350,250,175,125,100,75,50,25
1
6,5,2,3,20,0