1,1,1,1,1,1,1,1,1,1,1,1,1,1,1,1,1,1,1,1,1,1,1,1,1,1,1,1,1,1,1,1
1,2,2,2,2,2,2,2,2,2,2,2,1,1,1,1,1,1,1,1,2,2,2,2,2,2,2,2,2,2,2,1
1,2,0,0,2,2,0,0,0,0,0,2,2,2,2,2,2,2,2,2,2,0,0,0,0,0,2,2,0,0,2,1
1,2,0,0,2,0,2,2,3,2,2,0,2,0,0,0,3,0,0,2,0,2,2,3,2,2,0,2,0,0,2,1
1,2,-1,2,2,0,2,2,0,2,2,0,2,2,2,2,2,2,2,2,0,2,2,0,2,2,0,2,2,-1,2,1
1,2,0,2,0,2,2,2,0,2,2,2,0,2,0,0,0,0,2,0,2,2,2,0,2,2,2,0,2,0,2,1
1,2,0,2,0,2,2,2,0,2,2,2,0,2,0,2,2,2,2,0,2,2,2,0,2,2,2,0,2,0,2,1
1,2,0,2,0,2,2,2,0,2,2,2,0,2,0,2,0,0,2,0,2,2,2,0,2,2,2,0,2,0,2,1
1,2,0,2,0,0,0,0,0,0,0,0,0,2,2,2,2,2,2,0,0,0,0,0,0,0,0,0,2,0,2,1
1,2,0,2,0,2,2,2,-1,2,2,2,0,2,0,0,2,0,2,0,2,2,2,-1,2,2,2,0,2,0,2,1
1,2,-1,2,0,2,0,2,0,2,0,2,0,2,2,2,2,0,2,0,2,0,2,0,2,0,2,0,2,-1,2,1
1,2,0,2,0,2,0,2,0,2,0,2,0,2,0,0,2,0,2,0,2,0,2,0,2,0,2,0,2,0,2,1
1,2,0,2,0,2,0,2,0,2,0,2,0,2,2,2,2,0,2,0,2,0,2,0,2,0,2,0,2,0,2,1
1,2,0,2,0,2,2,6,2,6,2,2,0,2,0,0,0,0,2,0,2,2,6,2,6,2,2,0,2,0,2,1
1,2,0,2,0,2,2,2,2,2,2,2,0,2,2,2,2,2,2,0,2,2,2,2,2,2,2,0,2,0,2,1
1,2,-1,2,0,2,0,2,0,2,0,2,0,0,0,2,0,0,0,0,2,0,2,0,2,0,2,0,2,-1,2,1
1,2,0,2,0,2,0,2,0,2,0,2,0,2,2,2,2,2,2,0,2,0,2,0,2,0,2,0,2,0,2,1
1,2,0,2,0,2,0,2,0,2,0,2,0,2,0,0,2,0,2,0,2,0,2,0,2,0,2,0,2,0,2,1
1,2,0,2,0,2,2,6,2,6,2,2,0,2,0,3,2,0,2,0,2,2,6,2,6,2,2,0,2,0,2,1
1,2,0,2,0,2,2,2,2,2,2,2,0,2,0,2,0,0,2,0,2,2,2,2,2,2,2,0,2,0,2,1
1,2,2,2,0,2,0,2,0,2,0,2,0,2,2,2,2,2,2,0,2,0,2,0,2,0,2,0,2,2,2,1
1,2,0,0,0,2,0,6,0,6,0,2,0,0,0,2,2,0,0,0,2,0,6,0,6,0,2,0,0,0,2,1
1,2,2,2,2,2,2,2,2,2,2,2,2,2,2,2,2,2,2,2,2,2,2,2,2,2,2,2,2,2,2,1
1,1,1,1,1,1,1,1,1,1,1,1,1,1,1,1,1,1,1,1,1,1,1,1,1,1,1,1,1,1,1,1
29,4
2,4
29,15
2,10
29,10
2,15
3,2,385
8,9,23,9
1002,940,880,400,350,250,175,125,100,75,50,25
8
8,2,1,0,0,10
23,2,1,0,0,20
4,6,1,0,0,30
27,6,1,0,0,40
6,8,1,0,0,50
10,8,1,0,0,60
21,8,1,0,0,70
25,8,1,0,0,80