1,1,1,1,1,1,1,1,1,1,1,1,1,1,1,1,1,1,1,1,1,1,1,1,1,1,1,1,1,1,1,1
1,5,2,2,2,2,2,2,2,2,2,2,2,2,0,0,2,2,2,2,2,2,2,2,2,2,2,2,2,2,5,1
1,2,0,2,0,0,0,0,2,0,2,0,0,2,0,0,2,0,0,0,2,0,0,0,0,2,0,0,0,0,2,1
1,2,0,2,2,2,2,0,2,0,2,2,0,2,0,0,2,0,2,2,2,2,2,2,2,2,2,2,2,0,2,1
1,2,0,2,0,0,2,0,2,0,0,2,0,2,0,0,2,0,2,0,0,0,0,0,3,0,0,0,2,2,2,1
1,2,0,2,2,0,2,0,2,-1,0,2,2,2,2,0,2,2,2,2,0,2,2,2,2,2,2,0,2,0,2,1
1,2,0,0,2,3,2,2,2,-1,0,2,0,0,2,0,2,0,0,2,2,2,0,0,0,0,2,0,2,0,2,1
1,2,0,0,2,0,2,0,2,0,0,2,2,2,2,0,2,2,2,2,0,2,0,0,0,0,2,0,2,0,2,1
1,2,0,0,2,0,2,0,2,0,2,2,0,0,2,0,2,0,0,2,0,2,2,2,2,2,2,2,2,0,2,1
1,2,0,0,2,0,2,0,2,0,2,0,0,6,2,0,2,6,0,2,0,0,0,2,0,0,0,2,0,0,2,1
1,2,2,2,2,2,2,2,2,2,2,0,0,6,4,0,4,6,0,2,2,2,2,2,2,2,2,2,2,2,2,1
-1,0,0,0,0,0,0,0,0,0,0,0,0,6,6,6,6,6,0,0,0,0,0,0,0,0,0,0,0,0,0,-1
1,2,2,2,2,2,2,2,2,2,2,2,0,6,4,0,4,6,0,2,2,2,2,2,2,2,2,2,2,2,2,1
1,2,0,2,0,0,0,2,0,0,0,2,0,6,2,0,-1,6,0,2,0,0,0,2,0,0,2,0,0,0,2,1
1,2,0,2,2,2,2,2,2,2,0,2,0,0,2,0,-1,0,0,2,2,2,2,2,2,2,2,2,2,0,2,1
1,2,0,2,0,2,0,0,0,2,2,2,2,2,2,0,2,2,2,2,0,2,0,2,0,2,2,0,2,0,2,1
1,2,2,2,0,2,2,2,0,2,0,2,0,2,0,0,0,0,2,0,0,2,0,2,0,0,0,0,2,2,2,1
1,2,0,2,0,2,0,2,0,2,0,2,0,2,0,0,2,2,2,2,2,2,0,2,2,2,2,2,2,0,2,1
1,2,0,2,0,2,0,2,-1,2,0,2,0,2,2,0,2,0,2,0,2,2,0,2,0,-1,-1,0,2,0,2,1
1,2,0,2,0,2,0,2,0,2,0,2,0,0,2,0,2,0,2,0,0,0,0,2,0,0,0,0,2,0,2,1
1,2,0,2,2,3,2,2,0,2,0,2,2,2,2,0,2,0,2,2,2,2,2,2,2,2,2,2,3,0,2,1
1,2,0,2,0,0,0,2,0,2,0,0,0,0,2,0,2,0,0,0,2,0,0,0,2,0,0,0,2,0,2,1
1,5,2,2,2,2,2,2,2,2,2,2,2,2,2,0,2,2,2,2,2,2,2,2,2,2,2,2,2,2,5,1
1,1,1,1,1,1,1,1,1,1,1,1,1,1,1,1,1,1,1,1,1,1,1,1,1,1,1,1,1,1,1,1
16,13
16,14
9,6
26,18
9,5
25,18
3,2,380
8,18,8,18
1002,950,915,400,350,250,175,125,100,50,30,15
0