1,1,1,1,1,1,1,1,1,1,1,1,1,1,1,1,1,1,1,1,1,1,1,1,1,1,1,1,1,1,1,1
1,-1,2,2,2,2,2,2,2,2,2,2,2,2,2,2,2,2,2,2,2,2,2,2,2,2,2,2,2,2,2,1
1,2,0,0,0,0,0,0,0,0,0,0,0,0,0,0,0,0,0,0,0,2,0,0,0,0,0,0,2,0,2,1
1,2,0,2,2,2,2,2,2,2,2,3,2,2,2,2,2,2,2,2,0,2,2,2,2,2,3,0,2,0,2,1
1,2,0,2,0,0,0,0,0,0,0,0,0,0,0,0,0,0,0,2,0,2,2,0,0,2,2,2,2,0,2,1
1,2,0,2,2,2,2,2,2,2,2,2,2,2,2,2,2,2,2,2,0,-1,0,0,0,0,2,2,2,0,2,1
1,2,2,0,0,2,2,0,0,0,0,0,0,0,0,0,0,2,2,0,0,2,0,2,2,0,0,2,2,0,2,1
1,2,2,2,0,0,2,2,2,2,2,2,2,2,2,2,2,2,0,0,2,2,0,2,2,2,0,0,2,2,2,1
1,2,0,2,2,0,0,2,2,0,0,0,0,0,0,2,2,0,0,2,2,2,0,2,0,2,2,0,0,2,2,1
1,2,0,2,2,2,0,0,2,2,2,2,2,2,2,2,0,0,2,2,0,2,0,2,0,2,2,2,0,0,2,1
1,2,0,3,0,2,2,0,0,2,2,2,0,2,2,0,0,-1,-1,0,0,2,0,2,0,2,0,2,2,0,2,1
1,2,0,2,0,2,2,2,0,0,0,2,2,2,0,0,2,-1,-1,2,0,2,2,2,0,2,0,0,2,0,2,1
1,2,0,2,0,2,0,2,2,2,0,0,2,0,0,2,2,0,0,2,0,2,0,2,0,2,0,0,3,0,2,1
1,2,0,2,0,2,0,2,0,2,2,0,2,0,2,2,0,0,2,2,0,2,0,2,0,2,0,0,2,0,2,1
1,2,0,2,2,2,0,2,0,2,2,2,2,2,2,0,0,2,2,2,0,2,0,2,0,2,0,2,2,0,2,1
1,2,0,2,0,2,0,2,2,2,0,2,2,2,0,0,2,2,0,2,0,2,0,2,0,2,2,2,0,0,2,1
1,2,0,2,0,2,0,2,0,2,0,2,2,0,0,2,2,2,0,2,0,2,0,2,0,2,2,0,0,2,2,1
1,2,2,2,0,2,2,2,0,2,0,2,0,0,2,2,0,2,0,2,0,2,0,2,2,2,0,0,2,2,2,1
1,2,0,2,0,2,0,2,0,2,0,2,0,2,2,2,2,2,0,2,0,2,0,2,2,0,0,2,2,0,2,1
1,2,0,2,0,2,0,2,0,2,0,2,0,2,0,0,0,0,0,2,0,2,0,2,2,0,2,2,2,0,2,1
1,2,0,2,2,2,0,2,0,2,2,2,2,2,2,2,2,2,2,3,0,-1,0,0,0,2,2,0,2,0,2,1
1,2,0,0,2,2,0,2,0,2,0,2,0,0,0,0,0,0,0,0,0,2,0,0,2,2,0,0,2,0,2,1
1,2,2,2,2,2,2,2,2,2,2,2,2,2,2,2,2,2,2,2,2,2,2,2,2,2,2,2,2,2,-1,1
1,1,1,1,1,1,1,1,1,1,1,1,1,1,1,1,1,1,1,1,1,1,1,1,1,1,1,1,1,1,1,1
1,1
30,22
18,11
17,11
18,10
17,10
3,2,450
21,5,21,20
1002,875,775,340,280,200,150,120,80,50,45,25
0