1,1,1,1,1,1,1,1,1,1,1,1,1,1,1,1,1,1,1,1,1,1,1,1,1,1,1,1,1,1,1,1
1,-1,-1,-1,-1,-1,-1,-1,1,1,2,2,2,2,2,2,2,2,2,2,4,1,1,1,1,-1,-1,-1,-1,-1,-1,1
1,-1,-1,-1,-1,-1,-1,1,1,1,5,2,0,3,2,0,2,2,0,2,-1,1,2,2,2,1,-1,-1,-1,-1,-1,1
1,-1,-1,-1,-1,-1,1,2,2,-1,1,2,2,0,2,2,2,0,2,2,1,2,2,0,2,2,1,-1,-1,-1,-1,1
1,-1,-1,-1,-1,1,2,2,0,2,2,1,2,2,0,2,2,2,2,1,2,2,0,2,2,2,2,1,-1,-1,-1,1
1,-1,-1,-1,1,2,2,2,2,2,2,2,1,2,2,0,2,2,1,2,2,0,2,2,2,0,2,2,1,-1,-1,1
1,-1,-1,1,2,2,0,0,0,0,0,2,2,1,2,2,2,1,2,2,0,2,2,0,2,2,0,2,2,1,-1,1
1,1,1,2,2,2,2,2,2,2,2,2,2,2,1,1,1,2,2,0,2,2,0,2,2,2,2,0,2,2,1,1
-1,2,2,2,0,0,0,0,0,2,0,0,0,2,1,1,1,-1,2,2,2,0,3,2,2,0,2,2,2,2,2,-1
1,1,1,2,2,2,2,2,2,2,2,2,2,3,1,1,1,-1,2,0,2,2,2,2,0,2,2,0,2,2,1,1
1,-1,-1,1,2,2,0,0,0,0,0,2,2,1,2,-1,2,1,2,2,0,2,2,0,2,2,0,2,2,1,-1,1
1,-1,-1,-1,1,2,2,2,2,2,2,2,1,2,2,0,2,2,1,2,2,2,2,2,2,0,2,2,1,-1,-1,1
1,-1,-1,-1,1,1,2,2,0,2,2,1,2,2,2,0,2,2,2,1,2,2,0,0,0,2,2,1,1,1,-1,1
1,-1,-1,1,2,4,1,2,2,2,1,2,2,0,2,0,2,0,2,2,1,2,2,0,2,2,1,2,2,1,-1,1
1,-1,1,2,2,2,3,1,1,1,2,2,2,0,3,2,2,0,2,2,2,1,2,-1,2,1,3,2,2,5,1,1
1,1,2,2,2,0,2,2,1,1,2,0,2,2,2,0,2,0,2,0,2,2,1,1,1,2,2,0,2,2,1,1
1,1,2,0,2,2,0,2,2,1,2,2,2,0,2,0,2,0,2,0,2,2,1,1,2,2,0,2,2,2,1,1
1,1,2,2,0,2,2,0,2,2,1,2,2,0,2,0,2,2,2,0,2,2,1,2,2,0,2,2,2,1,-1,1
1,-1,1,2,2,0,2,2,2,2,2,1,2,2,2,0,2,0,2,2,2,1,2,2,2,2,2,2,1,-1,-1,1
1,-1,-1,1,2,2,0,2,2,0,2,2,1,2,2,0,2,0,2,2,1,2,2,0,2,2,2,1,-1,-1,-1,1
1,-1,-1,-1,1,2,2,2,2,2,0,2,2,1,2,2,2,2,2,1,2,2,0,2,2,2,1,-1,-1,-1,-1,1
1,-1,-1,-1,-1,1,2,2,0,2,2,0,2,2,1,2,2,2,1,2,2,0,-1,2,2,1,-1,-1,-1,-1,-1,1
1,-1,-1,-1,-1,1,1,5,2,2,2,2,2,2,1,1,1,1,1,4,2,2,2,2,1,-1,-1,-1,-1,-1,-1,1
1,1,1,1,1,1,1,1,1,1,1,1,1,1,1,1,1,1,1,1,1,1,1,1,1,1,1,1,1,1,1,1
17,8
17,9
15,10
22,21
9,3
23,14
3,2,310
20,2,20,2
1002,960,920,600,560,320,200,140,110,85,75,50
2
9,13,2,13,10,0
21,17,2,18,21,0