1,1,1,1,1,1,1,1,1,1,1,1,1,1,1,1,1,1,1,1,1,1,1,1,1,1,1,1,1,1,1,1
1,2,2,2,2,2,2,2,2,0,0,2,2,2,2,2,2,2,2,2,2,0,2,2,2,2,2,2,2,2,2,1
1,2,0,0,0,2,2,2,2,2,2,2,0,0,0,0,0,0,0,0,2,0,2,0,0,0,0,0,0,0,2,1
1,2,0,2,2,0,0,0,0,2,2,2,0,2,2,0,0,2,-1,0,2,0,2,0,2,2,2,-1,0,0,2,1
1,2,0,2,2,2,2,2,0,0,0,0,2,2,2,2,2,2,2,0,2,0,2,0,2,0,2,2,0,0,2,1
1,2,0,0,0,0,0,2,2,2,2,2,2,0,0,2,2,0,0,2,2,0,2,0,2,2,2,0,0,0,2,1
1,2,0,0,2,2,0,0,0,0,2,0,0,0,0,0,0,0,2,2,2,0,2,0,2,2,0,0,2,2,2,1
1,2,2,2,2,2,2,2,2,0,2,2,2,2,2,2,2,2,2,2,0,2,2,2,2,0,0,2,2,0,0,1
1,2,0,0,0,0,0,0,2,0,0,0,0,2,2,0,0,0,2,2,0,2,2,0,0,0,2,2,2,0,0,1
1,2,2,2,2,2,2,2,2,2,2,2,0,0,0,2,3,0,0,0,0,0,2,0,0,2,2,2,0,2,2,1
1,0,0,0,0,0,0,0,0,2,2,2,2,2,2,2,2,2,2,2,2,2,2,0,2,2,0,2,2,2,2,1
1,2,2,2,2,2,2,2,0,0,0,0,0,-1,2,0,0,0,0,0,2,2,0,0,2,2,0,0,0,0,2,1
1,2,0,2,0,0,0,2,0,0,2,-1,0,0,0,0,0,0,0,0,2,2,0,2,2,2,2,2,2,2,2,1
1,2,0,2,2,0,0,2,0,0,2,2,2,2,2,2,2,2,2,0,2,2,0,2,0,0,0,0,0,0,0,1
1,2,0,0,2,2,2,2,0,0,2,0,0,0,0,0,0,0,2,0,0,0,0,2,0,0,2,2,2,2,2,1
1,2,0,0,0,0,2,2,2,2,2,0,2,2,2,2,2,0,2,2,2,0,0,2,0,0,2,0,0,0,2,1
1,2,2,2,2,0,2,3,0,0,0,0,2,0,0,0,2,0,2,2,2,2,2,2,0,0,2,0,0,0,2,1
1,2,0,0,2,0,0,0,0,0,0,0,2,0,2,2,2,0,0,0,0,0,0,0,0,0,2,2,2,0,2,1
1,2,2,2,2,2,2,2,2,2,2,2,2,0,2,0,2,0,0,2,2,2,2,2,2,2,2,2,2,0,2,1
1,0,0,0,0,0,0,0,0,0,0,0,2,0,2,0,2,2,2,2,0,0,0,0,0,0,0,2,-1,0,2,1
1,-1,2,0,2,2,2,2,2,2,2,0,2,2,2,0,3,2,2,2,0,2,2,2,0,0,0,0,0,0,2,1
1,2,2,0,2,0,2,0,0,0,2,0,0,0,0,0,0,0,0,0,0,2,0,2,0,3,2,2,2,2,2,1
1,-1,2,2,2,0,2,2,2,2,2,2,2,2,2,2,2,2,2,2,2,2,0,2,2,2,2,2,2,2,0,1
1,1,1,1,1,1,1,1,1,1,1,1,1,1,1,1,1,1,1,1,1,1,1,1,1,1,1,1,1,1,1,1
1,20
1,22
11,12
28,19
27,3
18,3
3,2,420
11,12,13,11
1002,900,800,450,400,300,225,175,150,75,50,25
2
1,11,2,1,19,0
1,9,2,10,11,0