1,1,1,1,1,1,1,1,1,1,1,1,1,1,1,1,1,1,1,1,1,1,1,1,1,1,1,1,1,1,1,1
1,2,2,1,2,2,2,2,2,2,2,2,2,2,2,2,2,2,0,2,2,2,2,2,2,2,2,2,2,2,2,1
1,2,2,1,2,1,1,1,1,1,1,1,1,2,0,2,2,-1,0,2,1,1,1,1,1,1,1,2,1,2,2,1
1,1,1,1,2,2,2,2,2,2,2,2,2,2,0,0,0,0,0,2,2,2,2,2,2,2,2,2,1,1,1,1
1,2,2,2,2,0,0,0,0,2,0,0,0,2,2,2,2,2,2,2,0,0,0,2,0,0,0,2,2,2,2,1
1,2,-1,0,2,2,2,2,2,2,2,2,2,2,2,2,2,2,2,2,2,2,2,2,2,2,2,2,0,-1,-1,1
1,0,0,0,0,2,1,2,0,0,0,0,0,2,0,0,2,0,0,2,0,0,0,0,0,2,1,2,0,0,0,1
1,2,2,2,2,2,1,2,0,2,2,2,0,2,0,2,2,2,0,2,0,2,2,2,0,2,1,2,2,2,2,1
1,2,2,2,2,2,1,2,2,2,1,2,2,2,0,2,1,2,0,2,2,2,1,2,2,2,1,2,2,2,2,1
1,0,0,0,0,2,1,2,0,2,2,2,0,2,0,2,1,2,0,2,0,2,2,2,0,2,1,2,0,0,0,1
1,2,2,2,2,2,1,2,0,0,0,0,0,2,0,2,1,2,0,2,0,0,0,0,0,2,1,2,2,2,2,1
1,2,0,2,0,2,1,2,2,2,2,2,2,2,0,2,2,2,0,2,2,2,2,2,2,2,1,2,0,0,2,1
1,2,0,2,0,2,1,2,2,2,2,2,2,2,0,2,2,2,0,2,2,2,2,2,2,2,1,2,0,0,2,1
1,2,2,2,2,2,1,2,0,0,0,0,0,2,0,2,1,2,0,2,0,0,0,0,0,2,1,2,2,2,2,1
1,0,0,0,0,2,1,2,0,2,2,2,0,2,0,2,1,2,0,2,0,2,2,2,0,2,1,2,0,0,0,1
1,2,2,2,2,2,1,2,2,2,1,2,2,2,0,2,1,2,0,2,2,2,1,2,2,2,1,2,2,2,2,1
1,2,2,2,2,2,1,2,0,2,2,2,0,2,0,2,2,2,0,2,0,2,2,2,0,2,1,2,2,2,2,1
1,0,0,0,2,2,1,2,0,0,0,0,0,2,0,0,2,0,0,2,0,0,0,0,0,2,1,2,0,0,0,1
1,-1,-1,0,2,2,2,2,2,2,2,2,2,2,2,2,2,2,2,2,2,2,2,2,2,2,2,2,0,-1,2,1
1,2,2,2,2,0,0,0,0,2,0,0,0,2,2,2,2,2,2,2,0,0,0,2,0,0,0,2,2,2,2,1
1,1,1,1,2,2,2,2,2,2,2,2,2,2,0,0,0,0,0,2,2,2,2,2,2,2,2,2,1,1,1,1
1,2,2,1,2,1,1,1,1,1,1,1,1,2,0,-1,2,2,0,2,1,1,1,1,1,1,1,2,1,2,2,1
1,2,2,2,2,2,2,2,2,2,2,2,2,2,0,2,2,2,2,2,2,2,2,2,2,2,2,2,2,2,2,1
1,1,1,1,1,1,1,1,1,1,1,1,1,1,1,1,1,1,1,1,1,1,1,1,1,1,1,1,1,1,1,1
17,2
15,21
1,18
2,18
30,5
29,5
3,2,440
2,5,29,18
1002,900,800,425,375,275,200,150,125,75,50,25
1
30,21,2,3,1,0