1,1,1,1,1,1,1,1,1,1,1,1,1,1,1,1,1,1,1,1,1,1,1,1,1,1,1,1,1,1,1,1
1,2,2,2,2,2,2,2,2,2,2,2,2,2,2,2,2,2,2,2,2,2,2,2,2,2,2,2,2,2,2,1
1,2,1,1,1,1,1,2,1,1,6,1,1,2,1,1,6,1,2,1,1,6,1,1,3,1,1,1,1,1,2,1
1,2,1,2,2,2,1,2,1,2,2,2,1,2,1,2,2,1,2,1,2,2,2,1,2,1,2,2,2,1,2,1
1,2,1,2,1,2,1,2,1,2,1,2,1,2,1,2,2,1,2,1,2,1,2,1,2,1,2,1,2,1,2,1
1,2,1,2,2,2,1,2,1,2,2,2,1,2,1,1,6,1,2,1,2,2,2,1,2,1,2,2,2,1,2,1
1,2,1,1,1,6,1,2,1,1,1,1,1,2,2,2,2,2,2,1,1,1,1,1,2,1,1,1,1,1,2,1
1,2,2,2,2,2,2,2,2,2,2,2,2,2,1,1,6,1,2,2,-1,2,2,2,2,2,2,2,2,2,2,1
1,2,1,6,1,1,2,1,6,1,1,2,1,2,1,2,2,1,2,1,2,1,6,1,1,2,1,1,6,1,2,1
1,2,1,2,2,6,2,1,2,2,1,2,1,2,6,2,2,1,2,1,2,1,2,2,6,2,1,2,2,1,2,1
1,2,1,1,1,1,2,1,2,2,1,2,1,2,1,1,1,1,2,1,2,1,1,1,1,2,1,2,2,6,2,1
1,2,-1,2,2,2,2,1,1,6,1,2,2,2,2,-1,-1,2,2,1,2,2,2,2,2,2,1,1,1,1,2,1
1,2,1,1,1,1,2,2,2,2,2,2,1,2,2,-1,-1,2,2,2,2,1,6,1,1,2,2,2,2,-1,2,1
1,2,1,2,2,1,2,1,6,1,1,2,1,2,1,1,1,1,2,1,2,1,2,2,1,2,1,1,1,1,2,1
1,2,6,2,2,1,2,1,2,2,1,2,1,2,1,2,2,1,2,1,2,1,2,2,6,2,6,3,2,6,2,1
1,2,1,1,1,1,2,1,1,6,1,2,1,2,6,2,2,1,2,1,2,1,1,1,1,2,1,1,1,1,2,1
1,2,2,2,2,2,2,2,2,2,2,2,2,2,1,6,1,1,2,2,2,2,2,2,2,2,2,2,2,2,2,1
1,2,1,1,1,1,1,2,1,1,1,1,1,2,2,2,2,2,2,1,1,1,1,1,2,1,1,1,1,1,2,1
1,2,1,2,2,2,1,2,1,-1,2,2,1,2,1,1,1,1,2,1,2,2,2,1,2,1,2,2,2,1,2,1
1,2,1,2,1,2,1,2,1,2,1,2,1,2,6,2,2,1,2,1,2,1,2,1,2,1,2,1,2,1,2,1
1,2,1,2,2,2,1,2,1,3,2,2,1,2,1,2,2,6,2,1,2,2,2,1,2,1,2,2,2,1,2,1
1,2,1,1,1,6,1,2,1,1,1,1,1,2,1,1,1,1,2,1,1,1,6,1,2,1,1,1,1,1,2,1
1,2,2,2,2,2,2,2,2,2,2,2,2,2,2,2,2,2,2,2,2,2,2,2,2,2,2,2,2,2,2,1
1,1,1,1,1,1,1,1,1,1,1,1,1,1,1,1,1,1,1,1,1,1,1,1,1,1,1,1,1,1,1,1
29,12
2,11
15,11
16,11
15,12
16,12
3,2,430
9,18,20,7
1002,910,820,400,350,250,175,125,100,75,50,25
3
1,1,2,26,17,0
3,3,2,8,20,0
11,18,2,26,2,0