1,1,1,1,1,1,1,1,1,1,1,1,1,1,1,1,1,1,1,1,1,1,1,1,1,1,1,1,1,1,1,1
1,1,6,6,6,2,2,2,1,1,1,-1,2,2,2,2,2,2,2,2,-1,1,1,1,2,2,2,1,6,6,6,1
-1,6,6,1,1,0,0,2,2,3,2,2,0,2,0,0,2,0,2,0,2,2,3,2,2,0,2,1,6,1,6,-1
1,1,1,1,1,2,2,2,0,0,0,2,2,2,2,2,2,0,2,2,2,0,0,0,2,2,2,6,6,1,1,1
-1,6,6,1,1,2,0,2,2,2,0,0,0,2,0,0,2,0,2,0,0,0,2,2,2,0,0,1,1,6,6,-1
1,1,6,1,1,2,0,2,0,2,2,2,0,2,0,2,2,2,2,0,2,2,2,0,2,2,2,6,6,6,1,1
1,6,6,6,6,2,2,2,0,0,0,2,0,2,0,2,0,0,2,0,2,0,0,0,2,0,2,1,1,1,1,1
1,6,1,1,1,0,0,2,2,2,2,2,2,2,0,2,0,2,2,2,2,2,2,2,2,2,2,1,1,1,1,1
-1,6,1,1,1,2,2,2,0,0,0,0,0,2,2,2,2,2,0,0,0,0,0,0,2,0,0,1,6,6,6,-1
1,1,1,1,1,2,0,2,2,2,2,2,0,2,0,2,0,2,2,0,2,2,2,2,2,2,2,6,6,1,6,1
-1,6,1,1,1,2,0,2,0,2,0,2,-1,2,0,2,0,0,2,2,2,0,2,0,2,0,2,1,1,1,6,-1
1,6,1,1,1,2,0,2,0,2,0,2,0,2,2,2,2,2,2,0,2,0,2,0,2,0,2,1,1,1,6,1
1,6,6,1,1,2,0,2,2,2,0,2,0,2,0,0,0,2,2,0,2,2,2,0,2,0,2,1,1,1,6,1
1,1,6,6,6,2,0,2,0,0,0,2,0,2,2,2,0,0,2,0,-1,0,0,0,2,0,2,1,6,6,6,1
1,1,1,1,1,2,0,2,2,2,2,2,2,2,0,2,2,2,2,2,2,2,2,2,2,0,2,1,6,1,1,1
-1,6,6,1,1,2,2,2,0,0,0,0,0,2,0,2,0,2,0,0,0,0,0,0,2,2,2,1,6,1,6,-1
1,1,6,6,6,2,0,2,0,2,2,2,2,2,0,2,0,2,2,2,2,2,2,0,2,0,0,1,6,6,6,1
1,1,1,1,1,0,0,2,0,2,0,0,0,0,0,2,0,0,2,0,0,0,2,0,2,0,0,1,1,1,1,1
-1,6,1,1,1,2,2,2,2,2,2,2,0,2,2,2,2,2,2,0,2,2,2,2,2,2,2,1,1,6,6,-1
1,6,1,1,1,2,0,2,0,0,0,2,0,2,0,0,0,0,2,0,2,0,0,0,2,0,2,1,1,6,1,1
1,6,1,6,6,2,0,2,2,2,0,2,0,2,2,2,2,2,2,0,2,0,2,2,2,0,2,1,1,6,6,1
1,6,1,6,1,2,0,0,0,3,0,2,0,2,0,-1,-1,0,2,0,2,0,3,0,0,0,2,1,1,1,6,1
1,6,6,6,1,2,2,2,2,2,2,2,2,2,0,-1,-1,0,2,2,2,2,2,2,2,2,2,6,6,6,6,1
1,1,1,1,1,1,1,1,1,1,1,1,1,1,1,1,1,1,1,1,1,1,1,1,1,1,1,1,1,1,1,1
20,1
11,1
16,21
16,22
15,21
15,22
3,2,400
12,10,20,13
1002,900,800,410,375,275,200,150,125,75,50,25
0