1,1,1,1,1,1,1,1,1,1,1,1,1,1,1,1,1,1,1,1,1,1,1,1,1,1,1,1,1,1,1,1
1,2,2,2,2,2,2,2,2,2,2,0,0,2,2,2,2,2,2,0,0,2,2,2,2,2,0,2,2,2,2,1
1,3,0,0,2,0,2,0,0,0,2,2,0,2,0,0,0,0,2,2,2,2,0,0,2,2,0,2,0,0,3,1
1,2,0,2,2,0,2,2,2,0,2,2,0,2,2,0,2,2,2,0,2,0,2,2,2,2,0,2,0,2,2,1
1,2,0,2,2,0,2,0,2,2,2,0,0,2,2,2,2,0,2,0,2,0,2,0,0,0,0,2,2,2,2,1
1,2,2,2,2,2,2,2,2,2,2,2,2,2,0,0,0,0,2,2,2,2,2,2,2,2,2,2,0,0,2,1
1,0,0,0,2,0,2,0,0,0,0,0,0,0,2,2,2,2,0,0,0,0,0,0,0,2,0,0,0,2,2,1
1,2,2,2,2,0,2,0,2,2,2,2,2,2,2,0,2,2,2,2,2,2,2,2,2,2,0,2,2,2,2,1
1,2,0,2,2,0,2,2,2,2,0,0,2,0,2,2,2,0,0,2,0,0,2,0,2,2,0,2,0,0,2,1
1,2,0,2,0,0,2,0,2,0,2,2,2,2,2,2,0,2,2,2,0,0,2,0,0,2,0,2,2,2,2,1
1,2,2,2,2,0,2,0,2,0,2,0,2,2,0,2,2,2,0,2,2,0,2,0,0,2,0,0,0,2,0,1
1,0,2,0,2,0,2,0,2,0,2,0,0,0,0,2,0,0,0,0,2,0,2,0,2,2,2,2,0,2,0,1
1,2,2,2,2,2,2,0,2,2,2,2,2,2,2,2,2,-1,-1,0,2,2,2,0,2,0,0,2,0,2,2,1
1,2,0,2,2,0,2,2,2,0,2,2,0,0,2,2,2,-1,-1,0,2,0,2,0,2,0,0,2,2,2,2,1
1,2,0,0,2,0,2,0,2,0,2,0,2,2,0,2,0,0,0,0,2,0,2,0,2,2,0,2,0,0,0,1
1,2,2,0,2,0,2,0,2,0,2,2,2,2,0,2,2,2,0,2,2,0,2,0,0,2,0,2,2,2,2,1
1,2,2,2,2,0,2,0,2,2,0,2,2,2,0,2,0,2,2,2,0,2,2,2,2,2,0,0,0,0,2,1
1,0,0,0,2,0,2,0,0,2,2,0,0,0,2,2,2,0,0,2,2,2,0,0,0,2,0,2,2,2,2,1
1,2,2,2,2,2,2,2,2,2,2,2,2,2,2,-1,2,2,2,2,0,2,2,2,2,2,2,2,0,0,0,1
1,2,0,2,0,0,2,0,0,0,2,0,0,0,-1,0,-1,0,2,0,0,0,2,0,0,2,0,2,2,2,2,1
1,2,0,2,2,0,2,0,2,2,2,2,2,0,2,2,2,0,2,2,2,2,2,0,2,2,0,2,2,0,2,1
1,3,0,0,2,0,2,0,2,0,2,0,2,0,0,2,0,0,0,2,0,2,0,0,2,2,0,2,0,0,3,1
1,2,2,2,2,2,2,2,2,0,2,2,2,2,2,2,2,2,2,2,0,2,2,2,2,2,0,2,2,2,2,1
1,1,1,1,1,1,1,1,1,1,1,1,1,1,1,1,1,1,1,1,1,1,1,1,1,1,1,1,1,1,1,1
14,19
16,19
17,13
18,13
18,12
17,12
3,2,390
15,18,15,18
1002,880,760,400,350,250,175,125,100,30,20,10
0