1,1,1,1,1,1,1,1,1,1,1,1,1,1,1,1,1,1,1,1,1,1,1,1,1,1,1,1,1,1,1,1
1,2,2,2,2,2,2,2,2,1,2,2,2,2,2,2,2,2,2,2,2,2,1,5,2,2,2,2,2,2,5,1
1,2,0,0,-1,0,0,0,2,1,2,0,0,0,0,0,0,0,0,0,0,2,1,2,1,1,1,1,-1,1,2,1
-1,2,0,0,2,0,0,0,2,1,2,0,2,2,2,2,2,2,2,2,0,2,1,-1,2,2,2,2,2,1,-1,-1
1,2,0,0,-1,0,0,0,2,1,2,0,2,0,0,0,0,0,0,2,0,2,1,2,1,1,1,1,-1,1,2,1
1,2,2,2,2,2,2,2,2,1,2,0,2,0,2,2,2,2,0,2,0,2,1,5,2,2,2,2,2,2,5,1
1,1,1,1,1,1,1,1,2,1,2,0,2,0,2,0,0,2,0,2,0,2,1,0,0,0,0,0,0,1,0,1
-1,2,2,2,1,1,1,1,2,1,2,0,2,2,2,0,0,2,2,2,0,2,1,2,2,2,2,2,2,1,2,-1
1,2,2,2,1,2,2,2,2,1,2,0,2,0,2,0,0,2,0,2,0,2,1,2,1,2,1,1,2,1,2,1
1,2,1,1,1,2,0,0,2,1,2,0,2,0,2,0,4,2,0,2,0,2,1,2,1,2,1,1,2,1,2,1
1,2,2,2,2,2,2,2,2,1,2,0,2,0,2,0,0,2,0,2,0,2,1,2,1,-1,2,2,2,2,2,1
1,1,1,1,1,1,1,1,1,1,2,0,2,0,2,0,0,2,0,2,0,2,1,2,1,1,1,1,1,1,1,1
-1,2,2,2,2,2,2,2,2,1,2,0,2,0,2,0,0,2,0,2,0,2,1,2,1,2,2,2,2,2,2,-1
1,0,0,0,2,0,0,0,2,1,2,0,2,2,2,0,0,2,2,2,0,2,1,2,0,2,0,0,0,0,2,1
1,2,2,0,2,2,2,2,2,1,2,0,2,0,2,0,0,2,0,2,0,2,1,2,1,2,0,0,0,0,2,1
1,2,2,0,2,0,0,0,2,1,2,0,2,0,2,0,0,2,0,2,0,2,1,2,1,2,0,0,0,0,2,1
1,2,2,2,2,2,2,2,2,1,2,6,6,0,2,0,0,2,0,2,0,2,1,2,2,2,2,2,2,2,2,1
1,1,1,1,1,1,1,1,1,1,2,0,2,0,2,0,0,2,0,2,0,2,1,1,1,1,1,1,1,1,1,1
1,2,2,2,2,2,2,2,2,1,2,0,2,0,2,2,2,2,0,2,0,2,1,2,-1,2,2,2,2,2,2,1
1,2,0,0,0,1,1,0,1,1,2,0,2,0,0,0,2,0,0,2,0,2,1,2,0,0,0,0,0,0,2,1
1,2,2,2,2,2,2,2,2,1,2,0,2,2,2,2,2,2,2,3,0,2,1,2,0,0,0,0,0,0,2,1
1,1,0,1,1,0,1,1,2,1,2,0,0,0,0,0,0,0,0,0,0,2,1,2,0,0,0,0,0,0,2,1
-1,2,2,2,2,2,2,2,2,1,2,2,2,2,2,2,2,2,2,2,2,2,1,2,2,2,2,2,2,2,2,-1
1,1,1,1,1,1,1,1,1,1,1,1,1,1,1,1,1,1,1,1,1,1,1,1,1,1,1,1,1,1,1,1
4,2
4,4
28,2
23,3
28,4
30,3
3,2,500
25,10,24,18
1002,900,800,425,375,250,175,125,100,75,50,25
2
8,16,2,8,17,0
23,18,2,22,18,0