1,1,1,1,1,1,1,1,1,1,1,1,1,1,1,1,1,1,1,1,1,1,1,1,1,1,1,1,1,1,1,1
1,2,2,2,2,2,2,2,2,2,2,2,2,2,2,-1,2,2,2,2,2,2,2,2,2,2,2,2,2,2,2,1
1,2,0,0,0,2,0,0,0,0,2,0,0,0,0,2,0,0,0,0,2,0,0,0,0,2,0,0,0,0,2,1
1,2,0,2,2,2,2,2,2,2,2,2,2,2,2,2,2,2,2,2,2,2,2,2,2,2,2,2,2,2,2,1
1,2,0,2,2,1,1,1,1,1,1,1,1,1,1,1,1,1,1,1,1,1,1,1,1,1,1,1,1,0,2,1
1,2,0,2,2,1,2,2,2,2,2,2,2,2,2,2,2,2,2,2,2,2,2,2,2,2,2,3,1,2,2,1
1,2,0,0,2,1,2,1,1,1,1,2,1,2,1,1,1,1,2,1,2,1,2,1,1,1,1,2,1,2,0,1
1,2,2,2,2,1,2,1,2,2,1,2,1,2,2,2,2,1,2,1,2,1,2,2,2,2,2,2,1,2,2,1
1,2,0,0,2,1,2,2,2,2,2,2,1,1,1,1,2,1,2,2,2,2,2,2,1,1,1,1,1,0,2,1
1,2,2,0,2,1,1,1,1,1,1,1,1,-1,-1,1,2,1,1,2,1,1,1,2,1,2,2,2,2,2,2,1
1,2,2,0,2,2,2,-1,2,2,2,2,2,-1,-1,1,2,2,2,2,2,2,2,2,1,2,1,1,1,1,2,1
1,2,2,0,2,1,1,1,1,1,1,1,1,1,2,1,1,1,1,1,1,1,1,1,1,2,1,2,2,1,2,1
1,2,0,0,2,1,3,2,2,2,2,2,2,1,2,2,2,2,2,2,2,2,2,2,2,2,1,2,1,1,2,1
1,2,2,2,2,1,2,0,0,0,0,0,2,1,1,1,1,2,1,1,1,1,1,1,1,1,1,2,2,1,2,1
1,2,0,0,2,1,2,2,2,2,0,2,2,2,2,2,1,2,1,2,2,2,2,2,2,2,2,1,2,1,2,1
1,2,0,2,2,1,1,1,1,2,2,2,0,0,0,2,1,2,1,2,1,1,1,2,1,1,2,1,2,1,2,1
1,2,0,2,2,2,2,2,1,1,1,2,2,2,2,2,1,-1,1,2,1,2,2,2,2,2,2,2,2,1,2,1
1,2,0,0,0,2,0,2,2,2,1,1,1,1,1,1,1,2,1,2,1,2,1,1,1,1,1,2,2,1,2,1
1,2,2,2,2,2,0,2,0,2,2,2,0,2,2,2,2,2,1,3,2,2,1,2,2,2,1,2,2,1,2,1
1,2,0,0,2,0,0,2,0,0,0,2,0,2,0,0,0,2,1,1,1,1,1,2,0,2,1,1,1,1,2,1
1,2,2,2,2,2,2,2,2,2,2,2,0,2,2,0,2,2,2,0,2,2,2,2,0,2,2,2,2,2,2,1
1,2,0,0,0,2,0,0,0,2,0,2,0,2,2,0,2,0,2,0,2,0,2,2,0,2,0,0,0,0,2,1
1,2,2,2,2,2,2,2,2,2,2,2,2,2,2,-1,2,0,2,2,2,0,2,2,0,2,2,2,2,2,2,1
1,1,1,1,1,1,1,1,1,1,1,1,1,1,1,1,1,1,1,1,1,1,1,1,1,1,1,1,1,1,1,1
15,1
15,22
14,10
14,9
13,9
13,10
3,2,400
7,10,17,16
1002,880,760,440,400,300,225,175,150,50,30,10
3
9,17,2,9,16,0
15,14,2,14,8,0
20,6,2,28,10,0