1,1,1,1,1,1,1,1,1,1,1,1,1,1,1,1,1,1,1,1,1,1,1,1,1,1,1,1,1,1,1,1
1,2,2,2,1,2,2,2,2,2,2,2,0,2,2,5,2,2,2,0,2,2,2,2,2,2,2,1,2,2,2,1
1,2,0,2,2,2,0,2,1,2,0,2,0,2,0,0,0,0,2,0,2,0,2,1,2,0,2,2,2,0,2,1
1,2,0,2,0,2,3,2,1,2,0,2,0,2,2,2,2,2,2,0,2,0,2,1,2,3,2,0,2,0,2,1
1,2,0,2,0,2,0,2,1,2,0,2,0,2,0,0,0,0,2,0,2,0,2,1,2,0,2,0,2,0,2,1
1,2,0,2,0,2,0,2,1,2,2,2,2,2,2,2,2,2,2,2,2,2,2,1,2,0,2,0,2,0,2,1
1,2,2,2,0,2,0,2,1,2,1,1,1,1,2,0,0,2,1,1,1,1,2,1,2,0,2,0,2,2,2,1
1,2,0,2,2,2,0,2,1,2,1,1,1,1,2,0,0,2,1,1,1,1,2,1,2,0,2,2,2,0,2,1
1,2,0,2,0,2,2,2,1,2,2,2,2,1,2,2,2,2,1,2,2,2,2,1,2,2,2,0,2,0,2,1
1,2,0,2,2,2,0,2,1,6,6,6,2,1,2,0,0,2,1,2,6,6,6,1,2,0,2,2,2,0,2,1
1,2,2,2,0,2,0,2,1,6,6,6,2,1,2,-1,-1,2,1,2,6,6,6,1,2,2,2,0,2,2,2,1
-1,2,0,2,0,2,0,2,-1,6,6,6,2,6,2,2,2,2,6,2,6,6,6,-1,2,0,2,0,2,0,2,-1
1,2,0,2,0,2,0,2,1,6,6,6,2,1,2,-1,-1,2,1,2,6,6,6,1,2,0,2,0,2,0,2,1
1,2,0,2,0,2,2,2,1,6,6,6,2,1,2,0,0,2,1,2,6,6,6,1,2,0,2,0,2,0,2,1
1,2,0,2,2,2,0,2,1,2,2,2,2,1,2,2,2,2,1,2,2,2,2,1,2,0,2,2,2,0,2,1
1,2,2,2,0,2,0,2,1,2,1,1,1,1,2,0,0,2,1,1,1,1,2,1,2,2,2,0,2,2,2,1
1,2,0,2,2,2,0,2,1,2,1,1,1,1,2,0,0,2,1,1,1,1,2,1,2,0,2,2,2,0,2,1
1,2,0,2,0,2,3,2,1,2,2,2,2,2,2,2,2,2,2,2,2,2,2,1,2,3,2,0,2,0,2,1
1,2,0,2,0,2,0,2,1,2,0,2,0,2,0,0,0,0,2,0,2,0,2,1,2,0,2,0,2,0,2,1
1,2,0,2,0,2,0,2,1,2,0,2,0,2,2,2,2,2,2,0,2,0,2,1,2,0,2,0,2,0,2,1
1,2,2,2,0,2,0,2,1,2,0,2,0,2,0,0,0,0,2,0,2,0,2,1,2,0,2,0,2,2,2,1
1,2,2,2,2,2,-1,2,2,2,2,2,0,2,2,2,2,2,2,0,2,2,2,2,2,-1,2,2,2,2,2,1
1,1,1,1,1,1,4,1,1,1,1,1,1,1,1,1,1,1,1,1,1,1,1,1,1,4,1,1,1,1,1,1
1,1,1,1,1,1,1,1,1,1,1,1,1,1,1,1,1,1,1,1,1,1,1,1,1,1,1,1,1,1,1,1
6,21
25,21
16,12
15,12
16,10
15,10
3,2,360
8,11,23,11
1002,900,800,435,400,275,175,100,50,30,20,10
0