1,1,1,1,1,1,1,1,1,1,1,1,1,1,1,1,1,1,1,1,1,1,1,1,1,1,1,1,1,1,1,1
1,1,1,1,2,2,2,2,2,2,2,2,1,2,2,2,2,2,2,2,2,2,2,2,2,2,2,2,2,2,-1,1
1,1,1,2,2,2,1,1,2,2,0,2,1,2,0,0,0,0,0,0,0,0,0,3,0,0,2,0,2,0,2,1
1,1,2,2,1,1,-1,2,1,2,2,2,1,2,0,0,2,2,2,2,0,2,2,2,0,0,2,0,2,0,2,1
1,2,2,1,2,2,2,2,1,-1,-1,1,1,2,0,2,2,0,0,2,0,2,0,0,0,2,2,0,2,0,2,1
1,2,1,2,2,0,2,2,2,1,1,2,2,2,2,2,0,2,2,2,2,2,0,2,2,2,2,2,2,2,2,1
1,2,1,2,2,0,2,0,3,2,2,2,0,0,0,0,2,2,0,0,0,2,2,2,2,2,0,0,2,0,2,1
1,2,2,1,2,0,2,0,0,0,2,0,0,0,0,2,2,0,0,0,0,0,2,2,0,2,0,0,2,0,2,1
1,1,2,1,2,0,2,2,0,0,2,0,2,2,2,2,2,2,2,0,0,2,2,0,0,2,2,2,-1,0,2,1
1,1,2,1,2,2,0,2,2,2,2,2,2,0,0,0,0,2,2,0,2,2,2,2,0,0,2,2,0,0,2,1
1,2,2,2,1,2,2,0,2,0,0,0,2,0,0,2,2,2,2,2,2,0,0,2,2,0,0,2,2,2,2,1
1,2,0,2,1,1,2,2,2,0,0,0,2,2,2,2,0,0,2,0,2,2,0,0,2,2,0,2,0,0,2,1
1,2,0,2,1,1,2,0,2,0,2,2,2,0,0,0,0,2,2,0,0,2,2,0,0,2,0,2,0,0,2,1
1,2,2,2,1,1,2,0,2,0,2,0,0,0,2,2,2,2,0,0,2,2,2,2,2,2,2,2,2,2,2,1
1,2,0,0,0,0,2,0,2,0,2,0,0,2,2,2,2,0,0,0,2,0,0,0,0,2,0,0,0,0,2,1
1,2,0,2,2,2,2,2,2,2,2,2,2,2,2,2,2,2,2,2,2,0,0,2,2,2,0,0,0,0,2,1
1,2,0,2,0,0,0,0,0,0,0,0,0,2,2,2,2,0,0,0,2,2,2,2,0,2,2,0,0,0,2,1
1,2,1,2,2,0,2,2,2,0,2,2,2,0,2,2,2,2,0,0,0,0,3,0,0,0,2,0,0,0,2,1
1,2,1,0,-1,2,2,0,2,0,2,0,2,2,0,0,0,2,2,2,2,2,2,2,2,2,2,2,2,2,2,1
1,2,1,1,1,1,1,0,2,2,2,0,0,2,0,0,0,2,0,0,0,0,0,2,0,0,0,0,0,0,2,1
1,2,2,2,2,2,3,1,1,1,1,1,1,2,2,2,2,2,2,2,2,2,2,2,2,2,2,2,2,2,-1,1
1,2,0,0,0,0,2,2,2,2,2,2,2,1,1,1,1,1,1,1,1,1,1,1,1,1,1,1,1,1,1,1
1,2,2,2,2,2,2,1,1,1,1,1,2,2,2,2,2,2,2,2,2,2,2,2,2,2,2,2,2,2,2,1
1,1,1,1,1,1,1,1,1,1,1,1,1,1,1,1,1,1,1,1,1,1,1,1,1,1,1,1,1,1,1,1
9,4
10,4
30,1
30,20
4,18
6,3
3,2,390
28,8,28,8
1002,880,760,400,350,250,175,125,100,45,30,15
3
5,1,2,30,21,0
3,15,2,2,15,0
8,18,2,12,3,0