1,1,1,1,1,1,1,1,1,1,1,1,1,1,1,1,1,1,1,1,1,1,1,1,1,1,1,1,1,1,1,1
1,-1,2,2,2,1,1,1,1,1,1,2,2,2,2,2,2,2,2,2,2,1,2,2,2,1,2,2,2,-1,1,1
1,2,0,0,2,2,2,3,2,1,1,2,0,0,0,2,0,0,0,0,2,2,2,0,2,2,2,0,0,2,1,1
1,2,2,2,2,0,0,0,2,1,1,2,0,0,0,2,0,0,0,0,0,0,0,0,0,0,2,0,0,2,1,1
1,1,1,2,0,0,2,2,2,2,2,2,2,0,0,2,2,2,2,0,0,2,2,2,3,2,2,2,2,2,1,1
1,1,2,2,2,0,2,0,0,0,0,0,2,2,2,2,0,0,2,0,0,2,0,0,0,2,0,0,2,1,1,1
1,2,2,0,-1,0,2,2,2,2,2,0,2,0,0,0,0,2,2,2,2,2,0,2,2,2,0,0,2,2,2,1
1,2,0,0,2,2,2,0,0,0,2,0,2,0,0,0,0,2,0,0,0,2,0,2,0,2,0,0,2,0,2,1
1,2,2,2,2,1,2,0,0,0,2,2,2,0,2,2,2,2,0,0,0,2,2,2,0,2,2,-1,2,0,2,1
1,1,1,1,1,1,2,0,2,2,2,0,2,0,2,0,0,0,0,0,0,2,0,2,0,2,0,0,0,0,2,1
1,2,2,2,2,2,2,0,2,0,0,0,2,2,2,2,2,2,2,2,2,2,0,2,2,2,0,0,2,2,2,1
1,2,0,0,2,0,2,0,2,0,0,0,0,0,0,0,0,0,0,0,-1,0,0,0,0,2,0,0,2,1,1,1
1,2,0,0,2,0,2,0,2,0,0,0,0,0,2,2,2,2,0,0,-1,2,2,0,0,2,0,0,2,1,1,1
1,2,0,0,2,0,2,0,2,2,2,2,2,2,2,0,0,2,2,2,2,0,2,2,2,2,2,3,2,2,1,1
1,2,2,2,2,0,2,0,0,0,0,2,0,0,0,0,0,0,0,0,2,0,0,0,0,2,0,0,0,2,1,1
1,2,0,0,0,0,2,0,2,2,2,2,2,2,2,2,0,2,2,2,2,2,2,2,2,2,0,2,2,2,1,1
1,2,2,2,2,2,2,0,2,0,0,0,0,0,0,2,0,2,0,2,0,0,2,0,0,0,0,2,1,1,1,1
1,1,1,1,1,1,2,0,2,0,2,2,2,2,0,2,0,2,0,2,0,0,2,0,0,2,2,2,2,1,1,1
1,2,2,2,2,2,2,0,2,0,2,1,1,2,0,2,2,2,0,2,0,0,2,0,0,2,0,0,2,1,1,1
1,2,0,0,2,0,2,2,2,0,2,1,1,2,0,2,0,0,0,2,0,2,2,2,2,2,0,0,2,2,2,1
1,2,0,3,2,0,0,0,0,0,2,1,1,2,0,2,2,2,2,2,0,2,1,2,0,0,0,0,0,0,2,1
1,2,0,2,0,0,2,2,2,2,2,1,1,2,0,0,0,0,0,0,0,2,1,2,2,2,2,0,0,0,2,1
1,-1,2,2,2,2,2,1,1,1,1,1,1,2,2,2,2,2,2,2,2,2,1,1,1,1,2,2,2,2,-1,1
1,1,1,1,1,1,1,1,1,1,1,1,1,1,1,1,1,1,1,1,1,1,1,1,1,1,1,1,1,1,1,1
20,11
20,12
1,1
29,1
1,22
30,22
3,2,500
4,6,27,8
1002,900,800,400,325,250,175,125,100,50,45,35
0