1,1,1,1,1,1,1,1,1,1,1,1,1,1,1,1,1,1,1,1,1,1,1,1,1,1,1,1,1,1,1,1
1,2,2,2,2,2,2,2,2,2,2,2,2,2,2,-1,2,2,2,2,2,2,2,2,2,2,2,2,2,2,2,1
1,2,0,0,0,0,0,6,0,0,0,0,0,0,0,0,0,0,0,0,0,0,0,0,6,0,0,0,0,0,2,1
1,2,0,3,6,6,6,6,6,6,6,6,6,6,6,6,6,6,6,6,6,6,6,6,6,6,6,6,3,0,2,1
1,2,0,6,0,0,0,0,0,6,0,0,0,6,0,0,0,0,0,0,0,0,6,0,0,0,0,0,6,0,2,1
1,2,0,6,0,6,6,6,6,6,6,6,0,6,6,6,3,6,6,6,6,6,6,6,6,6,6,0,6,0,2,1
1,2,0,6,0,6,0,6,0,6,0,6,6,6,6,0,0,6,0,0,0,0,0,6,6,0,6,0,6,0,2,1
1,2,6,6,0,6,0,6,0,6,0,0,0,0,6,0,0,6,0,6,6,6,0,0,0,0,6,0,6,6,2,1
1,2,0,6,0,6,0,6,0,6,6,6,6,6,6,0,0,6,6,6,0,6,6,6,6,0,6,0,6,0,2,1
1,2,0,6,6,6,0,6,0,6,0,0,0,0,6,0,0,6,0,0,0,0,0,0,6,0,6,6,6,0,2,1
1,2,0,6,0,6,0,6,0,6,0,-1,6,6,6,0,0,6,6,6,-1,0,6,6,6,0,6,0,6,0,2,1
1,2,0,6,0,6,6,6,6,6,0,-1,6,6,6,0,0,6,6,6,-1,0,6,0,6,6,6,0,6,0,2,1
1,2,0,6,0,0,0,0,0,6,0,0,0,0,6,0,0,6,0,0,0,0,6,0,0,0,6,0,6,0,2,1
1,2,0,6,0,0,0,0,0,6,6,6,6,6,6,0,0,6,0,0,0,0,6,0,0,0,6,0,6,0,2,1
1,2,0,6,6,6,6,6,6,-1,0,0,0,0,6,0,0,6,0,6,6,6,-1,6,6,6,6,6,6,0,2,1
1,2,0,6,0,6,0,0,0,6,0,0,0,0,6,0,0,6,0,6,0,0,0,0,0,0,6,0,6,0,2,1
1,2,6,6,0,6,0,6,6,6,6,6,6,6,6,0,0,6,0,6,6,6,6,6,6,6,6,0,6,6,2,1
1,2,0,6,0,6,0,6,0,0,6,0,6,0,0,0,0,6,0,6,0,0,0,0,0,0,6,0,6,0,2,1
1,2,0,6,0,6,6,6,6,6,6,6,6,6,6,6,3,6,6,6,6,6,6,6,6,6,6,0,6,0,2,1
1,2,0,6,0,0,0,0,0,6,0,0,0,0,0,0,0,0,0,0,0,0,6,0,0,0,0,0,6,0,2,1
1,2,0,3,6,6,6,6,6,6,6,6,6,6,6,6,6,6,6,6,6,6,6,6,6,6,6,6,3,0,2,1
1,2,0,0,0,0,0,6,0,0,0,0,0,0,0,0,0,0,0,0,0,0,0,0,6,0,0,0,0,0,2,1
1,2,2,2,2,2,2,2,2,2,2,2,2,2,2,-1,2,2,2,2,2,2,2,2,2,2,2,2,2,2,2,1
1,1,1,1,1,1,1,1,1,1,1,1,1,1,1,1,1,1,1,1,1,1,1,1,1,1,1,1,1,1,1,1
15,1
15,22
20,10
20,11
11,11
11,10
3,2,420
9,14,22,14
1002,900,800,410,375,275,200,150,125,75,50,25
0