1,1,1,1,1,1,1,1,1,1,1,1,1,1,1,1,1,1,1,1,1,1,1,1,1,1,1,1,1,1,1,1
1,4,2,2,2,2,2,2,2,2,2,2,2,2,2,2,2,2,2,2,2,2,2,2,2,2,2,2,2,2,4,1
1,2,1,2,1,2,1,2,0,0,0,0,2,2,2,0,0,0,2,2,0,2,2,2,0,2,1,2,1,2,2,1
1,2,1,2,1,2,1,2,0,2,2,2,0,-1,0,2,2,2,0,-1,0,2,2,2,0,2,1,2,1,2,1,1
1,2,1,2,1,2,1,2,0,2,2,2,0,2,0,2,2,2,0,2,0,0,2,2,0,2,1,2,1,2,1,1
1,2,1,2,1,2,1,2,0,2,2,2,0,2,0,2,3,2,0,2,0,2,0,2,0,2,1,2,1,2,1,1
1,2,1,2,1,2,2,2,0,2,2,2,0,2,0,2,2,2,0,2,0,2,2,0,0,2,2,2,1,2,1,1
1,2,1,2,1,2,1,2,0,0,0,0,2,2,2,0,0,0,2,2,0,2,2,2,0,2,1,2,1,2,2,1
1,2,2,2,2,2,1,5,2,2,2,2,2,2,2,2,2,2,2,2,2,2,2,2,2,5,1,2,2,2,2,1
1,2,1,1,2,2,2,1,1,1,1,1,1,1,1,1,1,1,1,1,1,1,1,1,1,1,2,2,1,1,2,1
1,2,1,2,2,1,2,2,2,2,2,2,3,1,-1,2,2,2,-1,1,3,2,2,2,2,2,2,2,2,1,2,1
1,2,1,2,1,1,2,1,2,1,2,1,2,1,2,1,1,1,2,1,2,1,2,1,2,1,2,1,2,1,2,1
1,2,2,2,2,2,2,2,2,1,2,2,2,2,2,2,2,2,2,2,2,2,-1,1,2,2,2,2,2,2,2,1
-1,2,1,1,1,1,1,1,1,1,1,1,1,1,1,1,1,1,1,1,1,1,1,1,1,1,1,1,1,1,2,-1
1,1,5,2,-1,1,1,1,1,1,1,2,2,2,2,1,1,2,2,2,2,1,1,1,1,1,1,-1,2,5,1,1
1,2,2,2,2,2,2,2,2,2,2,2,2,2,2,2,2,2,2,2,2,2,2,2,2,2,2,2,2,2,2,1
1,2,0,2,2,0,2,2,0,0,2,2,0,2,2,0,2,2,0,0,2,2,0,2,2,2,2,6,0,2,2,1
1,2,0,0,0,0,2,0,2,2,0,2,0,2,2,0,2,0,2,2,0,2,0,2,2,2,0,2,2,0,2,1
1,2,0,2,2,0,2,0,2,2,0,2,0,6,2,0,2,0,2,2,0,2,0,2,2,2,0,2,2,0,2,1
1,2,0,2,2,0,2,0,0,6,0,2,0,2,6,0,2,0,2,2,0,2,0,2,2,2,0,2,2,0,2,1
1,2,0,2,2,0,2,0,2,2,0,2,0,2,2,0,2,0,2,2,0,2,0,2,2,2,0,2,2,0,2,1
1,2,0,2,2,0,2,0,2,2,0,2,0,2,2,0,2,2,0,6,2,2,0,0,0,2,2,0,0,2,2,1
1,4,2,2,2,2,2,2,2,2,2,3,2,2,2,2,2,2,2,2,2,3,2,2,2,2,2,2,2,2,4,1
1,1,1,1,1,1,1,1,1,1,1,1,1,1,1,1,1,1,1,1,1,1,1,1,1,1,1,1,1,1,1,1
14,10
18,10
27,14
4,14
19,3
13,3
3,2,450
22,12,22,12
1002,900,800,400,350,250,175,125,100,30,20,10
2
3,18,2,11,2,0
28,17,2,17,2,0