1,1,1,1,1,1,1,1,1,1,1,1,1,1,1,1,1,1,1,1,1,1,1,1,1,1,1,1,1,1,1,1
1,2,2,2,2,2,0,0,0,0,0,0,0,0,0,0,0,0,2,2,2,2,2,2,2,2,2,2,2,2,2,1
1,2,0,2,0,2,2,2,2,2,2,2,2,2,2,2,2,0,2,0,0,0,0,2,0,0,0,0,0,0,2,1
1,2,0,2,2,2,1,1,1,1,1,1,1,1,1,1,2,2,2,2,2,2,2,2,2,2,2,2,2,2,2,1
1,2,0,2,2,1,2,2,2,2,2,2,2,2,3,1,1,1,2,2,0,0,0,0,0,2,0,0,2,0,2,1
1,2,0,2,1,2,2,2,2,0,0,0,2,2,2,0,0,0,1,2,2,2,2,2,0,2,2,2,2,0,2,1
1,3,2,2,1,2,0,0,2,2,2,2,2,5,2,2,2,2,2,1,2,0,0,2,0,2,0,0,2,0,2,1
1,0,2,1,2,2,2,2,2,0,0,2,2,2,2,0,0,0,2,1,2,2,0,2,2,2,2,2,2,0,2,1
1,0,2,1,2,0,0,0,2,2,2,2,0,0,0,2,2,2,2,1,1,2,0,2,0,2,0,2,2,2,2,1
1,-1,2,1,2,0,2,2,2,0,0,2,2,2,2,2,1,1,1,2,2,2,0,2,0,2,0,2,0,0,2,1
1,2,1,1,2,0,2,0,0,2,2,2,2,1,1,1,2,2,2,2,0,2,2,2,0,2,2,2,0,0,2,1
1,2,1,1,2,0,2,0,2,2,1,1,1,-1,-1,2,2,0,0,2,0,2,0,2,2,2,0,2,0,0,2,1
-1,5,1,1,2,2,-1,2,2,4,4,2,2,-1,-1,2,2,2,2,2,2,2,0,2,0,2,-1,2,2,0,2,-1
1,2,1,1,2,0,2,0,2,1,1,1,1,1,1,1,1,1,1,1,1,2,0,2,0,2,0,0,2,2,2,1
1,2,1,1,2,0,2,0,2,2,2,2,2,2,2,2,2,2,2,2,1,2,2,2,0,2,0,2,2,0,2,1
1,-1,2,1,2,0,2,0,0,2,0,0,0,0,0,2,0,0,0,2,1,2,0,2,2,2,2,2,0,0,2,1
1,0,2,1,2,2,2,2,2,2,2,2,2,2,2,2,2,2,0,2,1,2,0,2,0,2,0,2,2,0,2,1
1,0,2,1,2,2,0,2,2,0,0,0,0,0,2,0,2,2,2,2,1,2,0,2,0,2,0,0,2,0,2,1
1,3,2,2,1,2,0,0,2,2,2,2,2,2,2,2,2,0,2,1,2,2,2,2,0,2,2,2,2,2,2,1
1,2,0,2,1,2,2,0,2,0,0,0,0,2,0,0,0,3,2,1,2,0,0,0,0,2,0,0,2,0,2,1
1,2,0,2,2,1,2,2,2,2,2,2,2,2,2,2,2,2,1,2,2,2,2,2,2,2,2,2,2,0,2,1
1,2,0,2,2,2,1,1,1,1,1,1,1,1,1,1,1,1,2,2,0,0,0,2,0,0,0,2,0,0,2,1
1,2,2,2,0,2,2,2,2,2,2,2,2,2,2,2,2,2,2,2,2,2,2,2,2,2,2,2,2,2,2,1
1,1,1,1,1,1,1,1,1,1,1,1,1,1,1,1,1,1,1,1,1,1,1,1,1,1,1,1,1,1,1,1
1,15
1,9
14,11
14,12
13,11
13,12
3,2,270
6,12,26,12
1002,900,800,450,400,300,225,175,150,75,50,25
0