1,1,1,1,1,1,1,1,1,1,1,1,1,1,1,1,1,1,1,1,1,1,1,1,1,1,1,1,1,1,1,1
1,2,2,2,2,2,2,2,2,2,2,2,2,2,2,2,2,2,2,2,2,2,2,2,2,2,2,2,2,2,2,1
1,3,0,0,0,0,0,0,0,0,0,0,2,0,0,0,0,0,0,2,0,0,0,0,0,0,0,0,0,0,3,1
1,2,0,2,2,2,2,0,2,2,2,0,2,2,2,2,2,2,2,2,2,2,0,2,2,2,2,2,2,0,2,1
1,2,0,2,0,0,2,0,2,0,2,0,0,0,0,2,2,0,0,0,0,2,0,2,0,0,0,0,2,0,2,1
1,2,0,2,2,2,2,2,2,0,2,0,2,2,2,2,2,2,2,2,0,2,2,2,2,2,2,2,2,0,2,1
1,2,0,0,0,0,0,0,0,0,2,0,2,0,0,0,0,0,0,2,0,2,0,0,0,0,0,0,0,0,2,1
1,2,2,2,2,2,2,2,2,2,2,2,2,2,2,2,-1,2,2,2,2,2,2,2,2,2,2,2,2,2,2,1
1,2,0,2,0,0,2,0,0,0,0,0,0,0,2,0,0,2,0,0,0,0,0,0,0,2,0,0,2,0,2,1
1,2,0,2,0,0,2,0,2,2,2,2,2,2,2,0,2,2,2,2,2,2,2,2,0,2,0,0,2,0,2,1
1,2,0,2,0,-1,2,2,2,0,2,0,2,0,2,0,2,2,0,2,0,2,0,2,2,2,-1,0,2,0,2,1
1,2,0,2,0,-1,2,2,2,0,2,0,2,0,2,0,0,2,0,2,0,2,0,2,2,2,-1,0,2,0,2,1
1,2,0,2,0,0,2,0,2,0,2,0,2,0,2,2,0,2,0,2,0,2,0,2,0,2,0,0,2,0,2,1
1,2,0,2,0,0,2,0,2,0,2,0,2,2,2,2,0,2,2,2,0,2,0,2,0,2,0,0,2,0,2,1
1,2,2,2,2,2,2,2,2,2,2,0,2,0,2,0,0,2,0,2,0,2,2,2,2,2,2,2,2,2,2,1
1,2,0,0,0,0,0,0,0,0,2,2,2,0,2,-1,2,2,0,2,2,2,0,0,0,0,0,0,0,0,2,1
1,2,0,2,2,2,2,2,2,0,0,2,0,0,0,0,0,0,0,0,2,0,0,2,2,2,2,2,2,0,2,1
1,2,0,2,0,2,0,0,2,0,2,2,0,2,2,0,2,2,2,0,2,2,0,2,0,0,2,0,2,0,2,1
1,2,0,2,0,2,2,2,2,2,2,2,2,2,2,0,2,0,2,0,2,2,2,2,2,2,2,0,2,0,2,1
1,2,0,2,0,0,0,0,2,0,0,0,2,0,0,0,2,0,2,2,2,2,0,2,0,0,0,0,2,0,2,1
1,2,0,2,2,2,2,2,2,0,2,2,2,2,2,2,2,2,2,0,2,2,0,2,2,2,2,2,2,0,2,1
1,3,0,0,0,0,0,0,0,0,2,0,0,0,0,2,0,2,0,0,0,2,0,0,0,0,0,0,0,0,3,1
1,2,2,2,2,2,2,2,2,2,2,2,2,2,2,2,0,2,2,2,2,2,2,2,2,2,2,2,2,2,2,1
1,1,1,1,1,1,1,1,1,1,1,1,1,1,1,1,1,1,1,1,1,1,1,1,1,1,1,1,1,1,1,1
15,15
16,7
26,10
26,11
5,11
5,10
3,2,400
15,12,15,12
0,0,0,0,0,0,0,0,0,0,0,0
0