1,1,1,1,1,1,1,1,1,1,1,1,1,1,1,1,1,1,1,1,1,1,1,1,1,1,1,1,1,1,1,1
1,2,2,2,2,2,2,2,2,2,2,2,2,2,2,2,2,2,2,2,2,2,2,2,2,2,2,2,2,2,2,1
1,2,1,2,0,2,2,0,2,0,0,0,0,2,0,2,0,0,2,0,2,0,0,2,2,0,0,2,2,1,2,1
1,2,1,2,0,2,2,0,2,0,-1,-1,0,2,0,2,0,0,2,0,2,0,0,2,0,2,2,6,2,1,2,1
1,2,1,2,0,0,0,0,2,0,0,0,0,2,0,2,0,0,2,0,2,0,0,2,0,2,2,0,2,1,2,1
1,2,1,2,0,2,2,0,2,0,2,2,0,2,0,2,2,2,2,0,2,2,2,2,0,-1,-1,0,2,1,2,1
1,2,1,2,0,2,2,0,2,0,2,2,0,2,0,0,0,0,2,0,0,0,0,2,2,0,0,2,2,1,2,1
1,2,2,2,2,2,2,2,2,2,2,2,2,2,2,2,2,2,2,2,2,2,2,2,2,2,2,2,2,2,2,1
1,0,0,3,0,0,0,0,0,0,0,0,0,2,0,0,0,0,0,0,0,0,0,3,0,0,0,0,2,0,0,1
1,2,2,2,0,2,2,2,2,2,-1,2,2,2,2,2,2,2,2,2,-1,2,2,2,2,2,2,0,2,2,2,1
1,2,0,0,0,2,0,0,0,0,2,0,0,0,2,2,0,2,2,0,2,0,2,0,0,0,2,0,0,0,2,1
1,2,2,-1,0,2,0,0,0,0,2,0,2,2,0,2,0,2,2,0,2,0,2,2,2,2,2,2,2,0,2,1
1,2,0,2,2,2,2,2,2,2,2,6,2,2,0,2,0,2,2,0,2,0,2,0,0,0,2,0,-1,2,2,1
1,2,0,0,0,2,0,0,0,0,2,0,0,0,2,2,2,0,0,2,2,0,2,0,0,0,2,0,0,0,2,1
1,2,2,2,0,2,2,2,2,2,2,2,2,2,2,2,2,2,2,2,2,2,2,2,2,2,2,0,2,2,2,1
1,0,0,2,0,0,0,0,3,0,0,0,0,0,0,0,0,0,2,0,0,0,0,0,0,0,0,0,3,0,0,1
1,2,2,2,2,2,2,2,2,2,2,2,2,2,1,1,1,1,2,2,2,2,2,2,2,2,2,2,2,2,2,1
1,2,0,0,0,0,0,2,0,0,2,0,0,2,2,2,2,2,2,0,0,2,0,0,2,0,0,0,0,0,2,1
1,2,2,2,2,2,0,2,0,2,2,2,0,2,0,0,0,0,2,0,2,2,2,0,2,0,2,2,2,0,2,1
1,2,0,2,1,2,2,2,0,2,1,2,0,2,2,2,2,2,2,0,2,1,2,0,2,2,2,1,2,2,2,1
1,2,0,2,2,2,0,2,0,2,2,2,0,2,0,0,0,0,2,0,2,2,2,0,2,0,2,2,2,0,2,1
1,2,0,0,0,0,0,2,0,0,2,0,0,2,2,-1,-1,2,2,0,0,2,0,0,2,0,0,0,0,0,2,1
1,2,2,2,2,2,2,2,2,2,2,2,2,2,1,1,1,1,2,2,2,2,2,2,2,2,2,2,2,2,2,1
1,1,1,1,1,1,1,1,1,1,1,1,1,1,1,1,1,1,1,1,1,1,1,1,1,1,1,1,1,1,1,1
10,9
20,9
15,21
16,21
26,5
25,5
3,2,500
3,11,28,12
1002,925,850,425,375,300,225,175,150,100,75,50
0