1,1,1,1,1,1,1,1,1,1,1,1,1,1,1,1,1,1,1,1,1,1,1,1,1,1,1,1,1,1,1,1
1,-1,2,4,5,1,2,2,2,1,2,2,2,2,2,2,1,2,2,1,2,2,2,1,2,2,2,1,2,2,2,1
1,-1,2,2,2,1,2,2,2,6,2,2,2,2,2,2,1,2,2,1,2,2,2,1,2,3,2,6,2,2,2,1
1,1,1,1,1,1,2,2,2,1,1,1,1,1,2,2,1,2,2,6,2,2,2,1,2,2,2,1,2,2,2,1
1,2,2,2,2,1,2,3,2,6,2,2,2,1,2,2,1,2,2,1,1,2,2,6,2,2,1,1,6,1,1,1
1,2,2,2,2,1,1,1,1,1,2,2,2,1,2,2,1,2,2,2,1,2,2,1,2,2,1,2,2,2,2,1
1,1,1,1,2,2,1,2,2,6,2,2,2,1,1,6,1,1,2,2,1,1,1,1,2,2,1,2,2,2,2,1
1,2,2,1,2,2,1,2,2,1,2,2,2,3,1,2,2,1,1,6,1,2,2,1,1,1,1,1,2,2,2,1
1,2,2,1,1,6,1,2,2,1,1,1,2,2,1,2,2,1,2,2,-1,2,2,6,2,2,2,1,2,2,2,1
1,2,2,1,2,2,1,2,2,2,2,1,1,1,1,2,2,1,2,2,2,2,1,1,2,2,2,1,5,2,4,1
1,2,3,1,2,2,1,2,2,2,2,2,1,2,2,2,2,1,1,1,1,1,1,2,2,1,1,1,1,1,1,1
1,2,2,1,2,2,1,2,2,2,2,2,1,2,2,2,2,1,2,2,2,3,1,2,2,1,2,2,2,2,2,1
1,6,1,1,2,2,1,1,1,1,6,1,1,1,1,2,2,6,2,2,2,2,1,2,2,6,2,2,2,2,2,1
1,2,2,1,2,2,2,1,2,2,2,2,2,-1,1,1,1,1,1,1,2,2,1,1,1,1,2,2,1,1,1,1
1,2,2,1,2,2,2,1,2,2,2,2,2,2,1,2,2,2,2,1,6,1,1,2,2,1,2,2,1,2,2,1
1,2,2,1,1,1,1,1,1,1,1,2,2,2,1,2,2,2,2,1,2,2,2,2,2,1,3,2,6,2,2,1
1,2,2,2,2,1,2,2,2,2,1,2,2,2,1,2,2,2,2,6,2,2,2,2,2,1,1,1,1,2,2,1
1,2,2,2,2,6,2,2,2,2,1,1,1,1,1,1,1,2,2,1,1,1,1,1,1,1,2,2,1,2,2,1
1,2,2,1,1,1,6,1,2,2,1,2,3,1,2,2,6,2,2,1,3,2,1,2,2,2,2,2,1,6,1,1
1,1,1,1,2,2,2,1,2,2,1,2,2,1,2,2,1,1,1,1,2,2,1,2,2,2,2,2,1,2,3,1
1,2,2,2,2,2,2,1,1,1,1,2,2,1,1,2,2,1,2,2,2,2,1,1,1,2,2,1,1,2,2,1
1,2,2,2,2,2,2,1,2,2,2,2,2,2,1,2,2,6,2,2,2,2,2,2,6,2,2,6,2,-1,-1,1
1,2,2,2,2,2,2,6,2,2,2,2,2,2,1,2,2,1,2,2,2,2,2,2,1,3,2,1,2,-1,-1,1
1,1,1,1,1,1,1,1,1,1,1,1,1,1,1,1,1,1,1,1,1,1,1,1,1,1,1,1,1,1,1,1
1,2
1,1
29,21
29,22
30,21
30,22
3,2,350
13,13,20,8
1002,920,840,450,375,300,225,175,150,100,85,50
6
4,2,2,4,3,300
4,10,2,3,10,300
12,18,2,12,17,300
4,4,2,4,3,300
2,10,2,3,10,300
12,16,2,12,17,300