1,1,1,1,1,1,1,1,1,1,1,1,1,1,1,1,1,1,1,1,1,1,1,1,1,1,1,1,1,1,1,1
1,2,2,2,2,2,2,2,2,0,3,2,2,2,2,2,2,2,2,2,2,3,0,2,2,2,2,2,2,2,2,1
1,2,0,0,2,0,2,0,2,0,2,0,0,2,0,0,0,0,0,2,0,2,0,2,0,2,0,2,0,0,2,1
1,2,0,0,2,0,2,0,2,2,2,2,2,2,2,2,2,2,2,2,2,2,2,2,0,2,0,2,0,0,2,1
1,2,0,0,2,0,2,0,2,0,0,2,0,0,0,2,2,0,0,0,2,0,0,2,0,2,0,2,0,0,2,1
1,2,0,0,2,0,2,0,2,0,0,2,0,2,2,2,2,2,2,0,2,0,0,2,0,2,0,2,0,0,2,1
1,2,2,2,2,0,2,0,2,2,0,2,0,2,0,0,0,0,2,0,2,0,2,2,0,2,0,2,2,2,2,1
1,2,0,2,0,2,2,2,0,2,0,2,0,2,0,-1,-1,0,2,0,2,0,2,0,2,2,2,0,2,0,2,1
1,2,0,2,0,2,0,2,0,2,0,2,2,2,0,-1,-1,0,2,2,2,0,2,0,2,0,2,0,2,0,2,1
1,2,0,2,0,2,2,2,0,2,0,2,0,0,0,0,0,0,0,0,2,0,2,0,2,2,2,0,2,0,2,1
1,2,0,2,0,2,0,0,0,2,2,2,2,2,2,2,2,2,2,2,2,2,2,0,2,0,0,0,2,0,2,1
1,2,2,2,0,2,2,0,0,-1,2,0,2,0,0,0,0,0,0,2,0,2,-1,0,2,2,0,0,2,2,2,1
1,1,2,2,2,0,2,0,2,2,2,0,2,2,2,2,2,2,0,2,0,2,2,2,0,2,0,2,2,2,1,1
1,1,2,0,2,2,2,2,2,0,2,0,2,0,0,2,0,2,0,2,0,2,0,2,2,2,2,2,0,2,1,1
-1,-1,2,0,0,0,2,0,0,0,2,0,2,0,0,2,0,2,0,2,0,2,0,0,0,2,0,0,0,2,-1,-1
1,1,2,0,2,2,2,2,2,0,2,0,2,2,0,2,2,2,2,2,0,2,0,2,2,2,2,2,0,2,1,1
1,2,2,0,2,0,0,0,2,0,2,2,0,2,0,0,0,0,2,0,2,2,0,2,0,0,0,2,0,2,2,1
1,2,0,2,2,2,2,2,2,2,0,2,2,2,2,2,2,2,2,2,2,0,2,2,2,2,2,2,2,0,2,1
1,2,0,2,0,0,0,2,0,2,0,2,0,2,0,2,0,0,2,0,2,0,2,0,0,0,2,0,2,0,2,1
1,2,0,2,0,2,2,2,0,2,0,2,0,2,0,2,0,0,2,0,2,0,2,0,2,2,2,0,2,0,2,1
1,2,2,2,2,3,0,2,2,2,2,2,0,2,0,2,2,0,2,0,2,2,2,2,3,0,2,2,2,2,2,1
1,2,0,0,0,0,0,0,0,0,0,2,0,2,0,0,2,0,2,0,2,0,0,0,0,0,0,0,0,0,2,1
1,2,2,2,2,2,2,2,2,2,2,2,2,2,2,2,2,2,2,2,2,2,2,2,2,2,2,2,2,2,2,1
1,1,1,1,1,1,1,1,1,1,1,1,1,1,1,1,1,1,1,1,1,1,1,1,1,1,1,1,1,1,1,1
30,14
1,14
16,7
16,8
15,7
15,8
3,2,460
9,11,22,11
1002,910,820,400,350,275,200,150,100,75,60,20
2
2,14,2,16,6,0
29,14,2,15,9,0