1,1,1,1,1,1,1,1,1,1,1,1,1,1,1,1,1,1,1,1,1,1,1,1,1,1,1,1,1,1,1,1
1,2,2,2,2,2,2,2,2,0,0,0,0,0,2,2,2,2,2,2,2,2,0,0,0,0,2,2,2,2,2,1
1,2,0,0,0,0,2,0,2,2,2,2,2,2,2,0,0,2,0,0,0,2,2,2,2,2,2,0,0,0,2,1
1,2,2,2,2,2,2,0,0,0,2,0,0,0,2,2,2,2,2,2,0,0,2,0,0,0,2,2,2,2,2,1
1,2,0,0,0,0,2,2,2,2,2,2,2,0,0,2,0,0,0,2,2,2,2,2,2,0,0,2,0,0,2,1
1,2,2,2,2,0,0,0,2,0,0,0,2,2,2,-1,2,2,0,0,2,0,0,0,2,2,2,2,2,0,2,1
1,2,0,0,2,2,2,2,2,2,2,0,0,0,2,0,0,2,2,2,2,2,2,0,0,2,0,0,2,2,3,1
1,3,2,0,0,0,2,0,0,0,2,2,2,2,2,2,0,0,0,2,0,0,2,2,2,2,2,0,0,0,2,1
1,2,2,2,2,2,2,2,2,0,0,0,2,0,0,2,2,2,2,2,2,0,0,0,2,0,2,2,2,2,2,1
1,2,0,0,0,2,0,0,2,2,2,2,2,2,0,0,0,2,0,0,2,2,2,2,2,0,0,0,0,0,2,1
1,2,2,2,2,2,2,0,0,0,2,0,0,2,2,2,2,2,2,0,0,2,0,0,2,2,2,2,2,2,2,1
1,2,0,0,0,0,2,2,2,-1,-1,2,2,2,0,0,0,0,2,2,-1,-1,2,2,2,0,0,0,0,0,2,1
1,2,0,0,0,0,2,2,2,-1,-1,2,2,2,0,0,0,0,2,2,-1,-1,2,2,2,0,0,0,0,0,2,1
1,2,2,2,2,2,2,0,0,0,2,0,0,2,2,2,2,2,2,0,0,2,0,0,2,2,2,2,2,2,2,1
1,2,0,0,0,2,0,0,2,2,2,2,2,2,0,0,0,2,0,0,2,2,2,2,2,0,0,0,0,0,2,1
1,2,2,2,2,2,2,2,2,0,0,0,2,0,0,2,2,2,2,2,2,0,0,0,2,0,2,2,2,2,2,1
1,3,2,0,0,0,2,0,0,0,2,2,2,2,2,2,0,0,0,2,0,0,2,2,2,2,2,0,0,0,2,1
1,2,0,0,2,2,2,2,2,2,2,0,0,0,2,0,0,2,2,2,2,2,2,0,0,2,0,0,2,2,3,1
1,2,2,2,2,0,0,0,2,0,0,0,2,2,2,-1,2,2,0,0,2,0,0,0,2,2,2,2,2,0,2,1
1,2,0,0,0,0,2,2,2,2,2,2,2,0,0,2,0,0,0,2,2,2,2,2,2,0,0,2,0,0,2,1
1,2,2,2,2,2,2,0,0,0,2,0,0,0,2,2,2,2,2,2,0,0,2,0,0,0,2,2,2,2,2,1
1,2,0,0,0,2,0,0,2,2,2,2,2,2,2,0,0,2,0,0,0,2,2,2,2,2,2,0,0,0,2,1
1,2,2,2,2,2,2,2,2,0,0,0,0,0,2,2,2,2,2,2,2,2,0,0,0,0,2,2,2,2,2,1
1,1,1,1,1,1,1,1,1,1,1,1,1,1,1,1,1,1,1,1,1,1,1,1,1,1,1,1,1,1,1,1
15,18
15,5
20,11
20,12
9,12
9,11
3,2,350
15,18,15,18
1002,925,850,330,290,215,165,115,90,40,30,16
0